image;segments;disk_size;slic_sigma;compactness;cut_off;x_dim;y_dim;pic_area;false_pos;false_neg;area;true_mask_area;common_area;area_diff;attribute_set
ISIC_0008524;400;1;1;10.0;0.6;4288;2848;12212224;4134850;13085;4134850;323767;310682;4147935;424
ISIC_0014428;450;3;2;10.0;0.6;4288;2848;12212224;1128313;8163;1128313;525860;517697;1136476;519
ISIC_0007332;50;4;1;0.1;0.6;3024;2016;6096384;5346113;0;5346113;530766;530766;5346113;47
ISIC_0013188;100;4;2;100.0;0.6;3008;2000;6016000;4739060;0;4739060;92544;92544;4739060;115
ISIC_0013128;350;3;3;100.0;0.6;3872;2592;10036224;4845079;0;4845079;470897;470897;4845079;405
ISIC_0014623;350;3;1;10.0;0.6;2592;1936;5018112;1040230;1054447;1040230;1937167;882720;2094677;394
ISIC_0014428;150;4;1;0.1;0.6;4288;2848;12212224;1650492;0;1650492;525860;525860;1650492;167
ISIC_0008524;50;3;3;0.01;0.6;4288;2848;12212224;7209295;19778;7209295;323767;303989;7229073;41
ISIC_0014623;350;2;2;100.0;0.6;2592;1936;5018112;1096108;1040131;1096108;1937167;897036;2136239;385
ISIC_0013128;450;4;2;0.1;0.6;3872;2592;10036224;4409135;0;4409135;470897;470897;4409135;532
ISIC_0014428;400;4;3;0.1;0.6;4288;2848;12212224;872435;10900;872435;525860;514960;883335;477
ISIC_0012547;450;1;2;10.0;0.6;4288;2848;12212224;11281493;0;11281493;572681;572681;11281493;489
ISIC_0014428;200;1;2;10.0;0.6;4288;2848;12212224;1568842;999;1568842;525860;524861;1569841;189
ISIC_0013082;400;3;2;10.0;0.6;3872;2592;10036224;1834348;0;1834348;254836;254836;1834348;459
ISIC_0003657;200;4;3;0.1;0.6;3024;2016;6096384;1809853;0;1809853;340261;340261;1809853;237
ISIC_0014428;250;1;3;0.1;0.6;4288;2848;12212224;1361517;0;1361517;525860;525860;1361517;252
ISIC_0013188;450;4;3;10.0;0.6;3008;2000;6016000;3126154;0;3126154;92544;92544;3126154;539
ISIC_0014428;50;1;2;100.0;0.6;4288;2848;12212224;2715313;1211;2715313;525860;524649;2716524;10
ISIC_0014428;250;3;2;100.0;0.6;4288;2848;12212224;1366468;4628;1366468;525860;521232;1371096;280
ISIC_0013082;350;3;1;10.0;0.6;3872;2592;10036224;1955526;0;1955526;254836;254836;1955526;394
ISIC_0014428;450;4;1;10.0;0.6;4288;2848;12212224;1128313;8163;1128313;525860;517697;1136476;529
ISIC_0007332;400;1;2;10.0;0.6;3024;2016;6096384;4811876;0;4811876;530766;530766;4811876;429
ISIC_0013128;100;3;3;10.0;0.6;3872;2592;10036224;6560098;0;6560098;470897;470897;6560098;104
ISIC_0012547;450;3;2;10.0;0.6;4288;2848;12212224;11227043;108900;11227043;572681;463781;11335943;519
ISIC_0013128;100;2;1;100.0;0.6;3872;2592;10036224;6775935;0;6775935;470897;470897;6775935;80
ISIC_0003657;50;3;2;1.0;0.6;3024;2016;6096384;2300580;56;2300580;340261;340205;2300636;38
ISIC_0012547;400;1;3;0.1;0.6;4288;2848;12212224;11324254;34923;11324254;572681;537758;11359177;432
ISIC_0003657;250;4;2;100.0;0.6;3024;2016;6096384;1668865;296;1668865;340261;339965;1669161;295
ISIC_0014428;100;2;2;0.1;0.6;4288;2848;12212224;2305415;0;2305415;525860;525860;2305415;82
ISIC_0008524;350;2;2;0.1;0.6;4288;2848;12212224;4022444;176;4022444;323767;323591;4022620;382
ISIC_0013082;350;2;1;0.01;0.6;3872;2592;10036224;1920228;0;1920228;254836;254836;1920228;376
ISIC_0013128;200;4;2;0.1;0.6;3872;2592;10036224;5514539;0;5514539;470897;470897;5514539;232
ISIC_0008524;250;2;2;100.0;0.6;4288;2848;12212224;4539288;7441;4539288;323767;316326;4546729;265
ISIC_0003657;450;1;2;100.0;0.6;3024;2016;6096384;1694939;1807;1694939;340261;338454;1696746;490
ISIC_0012547;250;4;3;0.01;0.6;4288;2848;12212224;11564745;0;11564745;572681;572681;11564745;296
ISIC_0007332;250;4;2;0.1;0.6;3024;2016;6096384;5105353;1090;5105353;530766;529676;5106443;292
ISIC_0013128;350;2;2;0.1;0.6;3872;2592;10036224;5005778;0;5005778;470897;470897;5005778;382
ISIC_0007332;200;2;2;0.1;0.6;3024;2016;6096384;5211533;0;5211533;530766;530766;5211533;202
ISIC_0013188;100;2;2;1.0;0.6;3008;2000;6016000;4800339;0;4800339;92544;92544;4800339;83
ISIC_0012547;100;4;3;0.01;0.6;4288;2848;12212224;0;572681;0;572681;0;572681;116
ISIC_0014712;450;3;3;100.0;0.6;6621;4422;29278062;1061978;18360557;1061978;24292916;5932359;19422535;525
ISIC_0014712;50;1;1;0.01;0.6;6621;4422;29278062;3842138;10031174;3842138;24292916;14261742;13873312;1
ISIC_0012547;150;3;2;0.01;0.6;4288;2848;12212224;0;572681;0;572681;0;572681;156
ISIC_0014428;300;3;3;0.01;0.6;4288;2848;12212224;1104132;2470;1104132;525860;523390;1106602;341
ISIC_0012547;300;4;2;10.0;0.6;4288;2848;12212224;11305044;163216;11305044;572681;409465;11468260;354
ISIC_0007332;50;3;2;0.01;0.6;3024;2016;6096384;0;530766;0;530766;0;530766;36
ISIC_0013082;50;2;2;100.0;0.6;3872;2592;10036224;3808604;0;3808604;254836;254836;3808604;25
ISIC_0012547;350;2;2;100.0;0.6;4288;2848;12212224;11254076;36400;11254076;572681;536281;11290476;385
ISIC_0013188;450;3;3;0.01;0.6;3008;2000;6016000;3139469;0;3139469;92544;92544;3139469;521
ISIC_0012547;50;3;3;10.0;0.6;4288;2848;12212224;10811912;0;10811912;572681;572681;10811912;44
ISIC_0014712;200;4;1;10.0;0.6;6621;4422;29278062;1245326;17361311;1245326;24292916;6931605;18606637;229
ISIC_0014623;250;3;3;100.0;0.6;2592;1936;5018112;1187982;1026842;1187982;1937167;910325;2214824;285
ISIC_0014428;300;2;2;100.0;0.6;4288;2848;12212224;1252280;1843;1252280;525860;524017;1254123;325
ISIC_0007332;100;1;1;100.0;0.6;3024;2016;6096384;0;530766;0;530766;0;530766;65
ISIC_0013188;150;1;3;0.01;0.6;3008;2000;6016000;4507809;0;4507809;92544;92544;4507809;131
ISIC_0014623;100;1;3;0.1;0.6;2592;1936;5018112;1779225;597233;1779225;1937167;1339934;2376458;72
ISIC_0008524;200;2;1;1.0;0.6;4288;2848;12212224;4756153;9847;4756153;323767;313920;4766000;198
ISIC_0012547;450;3;3;0.01;0.6;4288;2848;12212224;11241374;67651;11241374;572681;505030;11309025;521
ISIC_0013128;100;3;3;0.01;0.6;3872;2592;10036224;6734280;0;6734280;470897;470897;6734280;101
ISIC_0014712;450;3;1;0.01;0.6;6621;4422;29278062;1146116;17888980;1146116;24292916;6403936;19035096;511
ISIC_0013188;200;3;2;10.0;0.6;3008;2000;6016000;4007592;0;4007592;92544;92544;4007592;219
ISIC_0003657;400;4;2;0.01;0.6;3024;2016;6096384;1414900;19232;1414900;340261;321029;1434132;471
ISIC_0014712;300;1;1;0.1;0.6;6621;4422;29278062;1371124;16238184;1371124;24292916;8054732;17609308;302
ISIC_0013128;150;4;3;10.0;0.6;3872;2592;10036224;5678295;0;5678295;470897;470897;5678295;179
ISIC_0013188;350;2;1;100.0;0.6;3008;2000;6016000;3509667;0;3509667;92544;92544;3509667;380
ISIC_0003657;400;2;2;0.01;0.6;3024;2016;6096384;1695219;6277;1695219;340261;333984;1701496;441
ISIC_0014623;200;2;1;100.0;0.6;2592;1936;5018112;1310960;843853;1310960;1937167;1093314;2154813;200
ISIC_0014623;250;3;2;1.0;0.6;2592;1936;5018112;1187837;1026542;1187837;1937167;910625;2214379;278
ISIC_0013128;300;3;2;0.1;0.6;3872;2592;10036224;5075923;0;5075923;470897;470897;5075923;337
ISIC_0014428;400;4;1;100.0;0.6;4288;2848;12212224;1078368;2798;1078368;525860;523062;1081166;470
ISIC_0007332;200;2;2;0.01;0.6;3024;2016;6096384;5213773;0;5213773;530766;530766;5213773;201
ISIC_0012547;450;3;2;0.01;0.6;4288;2848;12212224;11239292;68424;11239292;572681;504257;11307716;516
ISIC_0014623;300;3;3;0.1;0.6;2592;1936;5018112;1080763;1113657;1080763;1937167;823510;2194420;342
ISIC_0013128;350;2;2;1.0;0.6;3872;2592;10036224;4996687;0;4996687;470897;470897;4996687;383
ISIC_0014428;300;1;2;0.01;0.6;4288;2848;12212224;1348933;634;1348933;525860;525226;1349567;306
ISIC_0013128;50;2;2;10.0;0.6;3872;2592;10036224;6971240;0;6971240;470897;470897;6971240;24
ISIC_0008524;250;3;2;1.0;0.6;4288;2848;12212224;4329828;9508;4329828;323767;314259;4339336;278
ISIC_0013128;50;4;2;100.0;0.6;3872;2592;10036224;6779338;0;6779338;470897;470897;6779338;55
ISIC_0013188;100;2;2;0.01;0.6;3008;2000;6016000;4867292;0;4867292;92544;92544;4867292;81
ISIC_0013128;150;1;2;0.1;0.6;3872;2592;10036224;5931884;0;5931884;470897;470897;5931884;127
ISIC_0013188;150;1;3;10.0;0.6;3008;2000;6016000;4477530;0;4477530;92544;92544;4477530;134
ISIC_0013128;250;3;2;0.1;0.6;3872;2592;10036224;5442170;0;5442170;470897;470897;5442170;277
ISIC_0007332;350;3;2;1.0;0.6;3024;2016;6096384;4872418;0;4872418;530766;530766;4872418;398
ISIC_0008524;200;3;1;10.0;0.6;4288;2848;12212224;4547387;11825;4547387;323767;311942;4559212;214
ISIC_0014428;300;1;3;100.0;0.6;4288;2848;12212224;1337726;1843;1337726;525860;524017;1339569;315
ISIC_0008524;200;1;3;10.0;0.6;4288;2848;12212224;4726483;11825;4726483;323767;311942;4738308;194
ISIC_0013082;300;4;2;100.0;0.6;3872;2592;10036224;2200847;224;2200847;254836;254612;2201071;355
ISIC_0014712;350;4;1;0.01;0.6;6621;4422;29278062;1129053;18493395;1129053;24292916;5799521;19622448;406
ISIC_0013188;200;3;3;0.1;0.6;3008;2000;6016000;4059631;0;4059631;92544;92544;4059631;222
ISIC_0014428;400;3;1;0.1;0.6;4288;2848;12212224;991915;1106;991915;525860;524754;993021;452
ISIC_0013128;150;4;1;10.0;0.6;3872;2592;10036224;5678264;0;5678264;470897;470897;5678264;169
ISIC_0013188;350;3;2;0.01;0.6;3008;2000;6016000;3481886;420;3481886;92544;92124;3482306;396
ISIC_0014428;300;4;2;10.0;0.6;4288;2848;12212224;1211476;1843;1211476;525860;524017;1213319;354
ISIC_0012547;300;1;3;10.0;0.6;4288;2848;12212224;11388053;0;11388053;572681;572681;11388053;314
ISIC_0013128;250;4;2;0.1;0.6;3872;2592;10036224;5354002;0;5354002;470897;470897;5354002;292
ISIC_0014712;350;1;3;0.01;0.6;6621;4422;29278062;1036682;16064537;1036682;24292916;8228379;17101219;371
ISIC_0014712;200;2;3;10.0;0.6;6621;4422;29278062;1408737;16226776;1408737;24292916;8066140;17635513;209
ISIC_0007332;250;1;1;0.01;0.6;3024;2016;6096384;5220295;0;5220295;530766;530766;5220295;241
ISIC_0014623;50;4;1;100.0;0.6;2592;1936;5018112;2054518;436911;2054518;1937167;1500256;2491429;50
ISIC_0003657;200;2;1;10.0;0.6;3024;2016;6096384;1905638;1525;1905638;340261;338736;1907163;199
ISIC_0013188;150;1;1;0.1;0.6;3008;2000;6016000;4473548;0;4473548;92544;92544;4473548;122
ISIC_0014428;250;3;3;1.0;0.6;4288;2848;12212224;1411190;0;1411190;525860;525860;1411190;283
ISIC_0013128;150;1;1;0.1;0.6;3872;2592;10036224;5934981;0;5934981;470897;470897;5934981;122
ISIC_0013128;150;4;3;0.1;0.6;3872;2592;10036224;5713448;0;5713448;470897;470897;5713448;177
ISIC_0014428;250;1;1;10.0;0.6;4288;2848;12212224;1469675;4628;1469675;525860;521232;1474303;244
ISIC_0013082;50;4;3;0.01;0.6;3872;2592;10036224;3435777;7523;3435777;254836;247313;3443300;56
ISIC_0007332;100;2;1;1.0;0.6;3024;2016;6096384;0;530766;0;530766;0;530766;78
ISIC_0014428;150;4;2;100.0;0.6;4288;2848;12212224;1828088;990;1828088;525860;524870;1829078;175
ISIC_0012547;250;4;3;1.0;0.6;4288;2848;12212224;11493885;0;11493885;572681;572681;11493885;298
ISIC_0014623;200;1;2;0.1;0.6;2592;1936;5018112;1382692;815341;1382692;1937167;1121826;2198033;187
ISIC_0007332;50;2;1;1.0;0.6;3024;2016;6096384;5117285;0;5117285;530766;530766;5117285;18
ISIC_0013128;350;3;2;1.0;0.6;3872;2592;10036224;4845662;0;4845662;470897;470897;4845662;398
ISIC_0013188;150;1;2;1.0;0.6;3008;2000;6016000;4436598;0;4436598;92544;92544;4436598;128
ISIC_0003657;450;1;3;0.1;0.6;3024;2016;6096384;1744515;0;1744515;340261;340261;1744515;492
ISIC_0014428;450;4;2;100.0;0.6;4288;2848;12212224;1128313;8163;1128313;525860;517697;1136476;535
ISIC_0012547;250;4;3;0.1;0.6;4288;2848;12212224;11533048;47731;11533048;572681;524950;11580779;297
ISIC_0013128;50;1;3;1.0;0.6;3872;2592;10036224;6961159;0;6961159;470897;470897;6961159;13
ISIC_0014428;350;2;1;100.0;0.6;4288;2848;12212224;1232873;6259;1232873;525860;519601;1239132;380
ISIC_0003657;350;2;3;100.0;0.6;3024;2016;6096384;1646878;2927;1646878;340261;337334;1649805;390
ISIC_0012547;250;3;1;10.0;0.6;4288;2848;12212224;11494346;0;11494346;572681;572681;11494346;274
ISIC_0014428;400;2;1;0.1;0.6;4288;2848;12212224;1023674;1095;1023674;525860;524765;1024769;437
ISIC_0013082;450;1;1;0.1;0.6;3872;2592;10036224;1505664;1149;1505664;254836;253687;1506813;482
ISIC_0014623;450;3;3;0.1;0.6;2592;1936;5018112;929088;1177974;929088;1937167;759193;2107062;522
ISIC_0008524;300;2;3;100.0;0.6;4288;2848;12212224;4395438;4070;4395438;323767;319697;4399508;330
ISIC_0013188;250;2;2;100.0;0.6;3008;2000;6016000;3820331;0;3820331;92544;92544;3820331;265
ISIC_0014428;400;3;1;100.0;0.6;4288;2848;12212224;1108993;2798;1108993;525860;523062;1111791;455
ISIC_0008524;450;3;3;0.1;0.6;4288;2848;12212224;3737868;13009;3737868;323767;310758;3750877;522
ISIC_0012547;50;1;2;100.0;0.6;4288;2848;12212224;10812141;0;10812141;572681;572681;10812141;10
ISIC_0014712;200;3;1;0.01;0.6;6621;4422;29278062;1649640;16037890;1649640;24292916;8255026;17687530;211
ISIC_0008524;400;4;1;0.1;0.6;4288;2848;12212224;3134643;3696;3134643;323767;320071;3138339;467
ISIC_0014623;200;4;2;0.1;0.6;2592;1936;5018112;1109431;983083;1109431;1937167;954084;2092514;232
ISIC_0013082;150;1;3;0.1;0.6;3872;2592;10036224;2799114;0;2799114;254836;254836;2799114;132
ISIC_0003657;50;1;3;100.0;0.6;3024;2016;6096384;2884231;72;2884231;340261;340189;2884303;15
ISIC_0013082;150;3;3;10.0;0.6;3872;2592;10036224;2759696;183;2759696;254836;254653;2759879;164
ISIC_0014623;200;2;1;0.1;0.6;2592;1936;5018112;1301531;844804;1301531;1937167;1092363;2146335;197
ISIC_0013082;300;2;2;0.01;0.6;3872;2592;10036224;1993131;2525;1993131;254836;252311;1995656;321
ISIC_0012547;400;3;1;1.0;0.6;4288;2848;12212224;11191963;61250;11191963;572681;511431;11253213;453
ISIC_0008524;150;1;3;0.01;0.6;4288;2848;12212224;5504198;0;5504198;323767;323767;5504198;131
ISIC_0013188;450;2;3;1.0;0.6;3008;2000;6016000;3152361;357;3152361;92544;92187;3152718;508
ISIC_0013188;200;1;1;10.0;0.6;3008;2000;6016000;4007582;0;4007582;92544;92544;4007582;184
ISIC_0012547;100;4;2;0.01;0.6;4288;2848;12212224;0;572681;0;572681;0;572681;111
ISIC_0013082;450;4;1;10.0;0.6;3872;2592;10036224;1722794;1608;1722794;254836;253228;1724402;529
ISIC_0008524;300;3;1;0.01;0.6;4288;2848;12212224;4511527;0;4511527;323767;323767;4511527;331
ISIC_0013128;300;2;2;100.0;0.6;3872;2592;10036224;5142297;39;5142297;470897;470858;5142336;325
ISIC_0014623;50;1;2;10.0;0.6;2592;1936;5018112;2352646;423093;2352646;1937167;1514074;2775739;9
ISIC_0007332;200;1;1;1.0;0.6;3024;2016;6096384;5166848;0;5166848;530766;530766;5166848;183
ISIC_0014623;300;4;3;0.1;0.6;2592;1936;5018112;1012819;1130582;1012819;1937167;806585;2143401;357
ISIC_0014712;100;4;3;0.1;0.6;6621;4422;29278062;3201373;14758397;3201373;24292916;9534519;17959770;117
ISIC_0014712;150;2;1;1.0;0.6;6621;4422;29278062;1999260;15165274;1999260;24292916;9127642;17164534;138
ISIC_0013082;100;1;1;0.1;0.6;3872;2592;10036224;2989131;0;2989131;254836;254836;2989131;62
ISIC_0014623;250;2;1;0.01;0.6;2592;1936;5018112;1340503;851077;1340503;1937167;1086090;2191580;256
ISIC_0013128;300;3;1;100.0;0.6;3872;2592;10036224;5070889;39;5070889;470897;470858;5070928;335
ISIC_0012547;100;2;3;10.0;0.6;4288;2848;12212224;0;572681;0;572681;0;572681;89
ISIC_0008524;250;1;2;10.0;0.6;4288;2848;12212224;4539295;7441;4539295;323767;316326;4546736;249
ISIC_0013082;300;1;1;1.0;0.6;3872;2592;10036224;2130111;1220;2130111;254836;253616;2131331;303
ISIC_0013082;450;4;1;0.01;0.6;3872;2592;10036224;1698914;1608;1698914;254836;253228;1700522;526
ISIC_0014712;50;3;2;10.0;0.6;6621;4422;29278062;2849635;13299682;2849635;24292916;10993234;16149317;39
ISIC_0014712;300;4;1;1.0;0.6;6621;4422;29278062;1314375;18364692;1314375;24292916;5928224;19679067;348
ISIC_0013082;450;1;1;10.0;0.6;3872;2592;10036224;1722793;1608;1722793;254836;253228;1724401;484
ISIC_0013128;100;3;2;10.0;0.6;3872;2592;10036224;6560097;0;6560097;470897;470897;6560097;99
ISIC_0013188;150;4;2;0.1;0.6;3008;2000;6016000;4397411;0;4397411;92544;92544;4397411;172
ISIC_0013188;100;1;3;100.0;0.6;3008;2000;6016000;4864414;0;4864414;92544;92544;4864414;75
ISIC_0013128;350;4;3;10.0;0.6;3872;2592;10036224;4753820;0;4753820;470897;470897;4753820;419
ISIC_0013082;300;4;1;10.0;0.6;3872;2592;10036224;2200750;224;2200750;254836;254612;2200974;349
ISIC_0014712;300;4;3;0.01;0.6;6621;4422;29278062;1337934;18266974;1337934;24292916;6025942;19604908;356
ISIC_0013188;450;2;1;0.01;0.6;3008;2000;6016000;3323939;0;3323939;92544;92544;3323939;496
ISIC_0014428;350;2;3;0.01;0.6;4288;2848;12212224;930103;4351;930103;525860;521509;934454;386
ISIC_0013188;300;2;2;0.01;0.6;3008;2000;6016000;3816481;0;3816481;92544;92544;3816481;321
ISIC_0014712;50;2;2;100.0;0.6;6621;4422;29278062;2849637;13299678;2849637;24292916;10993238;16149315;25
ISIC_0014428;150;4;1;1.0;0.6;4288;2848;12212224;1821728;3279;1821728;525860;522581;1825007;168
ISIC_0014712;100;1;2;100.0;0.6;6621;4422;29278062;3652301;10960584;3652301;24292916;13332332;14612885;70
ISIC_0013082;50;3;1;10.0;0.6;3872;2592;10036224;3808920;0;3808920;254836;254836;3808920;34
ISIC_0007332;100;3;1;1.0;0.6;3024;2016;6096384;0;530766;0;530766;0;530766;93
ISIC_0008524;150;1;1;0.01;0.6;4288;2848;12212224;5308958;0;5308958;323767;323767;5308958;121
ISIC_0013082;100;4;1;10.0;0.6;3872;2592;10036224;2998467;0;2998467;254836;254836;2998467;109
ISIC_0013128;450;1;1;0.01;0.6;3872;2592;10036224;4972817;0;4972817;470897;470897;4972817;481
ISIC_0013082;150;1;2;0.1;0.6;3872;2592;10036224;2714242;0;2714242;254836;254836;2714242;127
ISIC_0013082;250;3;3;1.0;0.6;3872;2592;10036224;2106212;0;2106212;254836;254836;2106212;283
ISIC_0014712;400;1;2;10.0;0.6;6621;4422;29278062;1404245;16479688;1404245;24292916;7813228;17883933;429
ISIC_0008524;50;4;1;10.0;0.6;4288;2848;12212224;5718021;11966;5718021;323767;311801;5729987;49
ISIC_0014623;450;4;3;100.0;0.6;2592;1936;5018112;875454;1217729;875454;1937167;719438;2093183;540
ISIC_0014712;350;1;1;0.01;0.6;6621;4422;29278062;1123841;15729951;1123841;24292916;8562965;16853792;361
ISIC_0012547;150;4;1;100.0;0.6;4288;2848;12212224;11558318;0;11558318;572681;572681;11558318;170
ISIC_0003657;150;2;3;0.01;0.6;3024;2016;6096384;2187105;18529;2187105;340261;321732;2205634;146
ISIC_0007332;50;3;3;0.01;0.6;3024;2016;6096384;0;530766;0;530766;0;530766;41
ISIC_0013082;350;1;2;10.0;0.6;3872;2592;10036224;1955525;0;1955525;254836;254836;1955525;369
ISIC_0014712;300;4;3;0.1;0.6;6621;4422;29278062;1363084;18762678;1363084;24292916;5530238;20125762;357
ISIC_0012547;200;1;1;0.1;0.6;4288;2848;12212224;11509715;0;11509715;572681;572681;11509715;182
ISIC_0014623;450;3;2;0.01;0.6;2592;1936;5018112;962634;1181302;962634;1937167;755865;2143936;516
ISIC_0013128;150;1;1;0.01;0.6;3872;2592;10036224;6454336;0;6454336;470897;470897;6454336;121
ISIC_0003657;50;3;1;0.01;0.6;3024;2016;6096384;3318763;0;3318763;340261;340261;3318763;31
ISIC_0012547;300;3;2;100.0;0.6;4288;2848;12212224;11305031;81608;11305031;572681;491073;11386639;340
ISIC_0003657;350;2;2;0.1;0.6;3024;2016;6096384;1731797;0;1731797;340261;340261;1731797;382
ISIC_0013082;150;4;3;100.0;0.6;3872;2592;10036224;2759697;183;2759697;254836;254653;2759880;180
ISIC_0007332;450;4;3;0.01;0.6;3024;2016;6096384;4539488;1782;4539488;530766;528984;4541270;536
ISIC_0003657;300;4;1;0.1;0.6;3024;2016;6096384;1531913;4241;1531913;340261;336020;1536154;347
ISIC_0007332;250;4;2;0.01;0.6;3024;2016;6096384;5106957;0;5106957;530766;530766;5106957;291
ISIC_0007332;200;4;1;10.0;0.6;3024;2016;6096384;5168994;0;5168994;530766;530766;5168994;229
ISIC_0008524;200;1;1;0.1;0.6;4288;2848;12212224;4957517;3090;4957517;323767;320677;4960607;182
ISIC_0003657;200;2;2;0.1;0.6;3024;2016;6096384;2007806;0;2007806;340261;340261;2007806;202
ISIC_0008524;250;4;1;1.0;0.6;4288;2848;12212224;3691730;9127;3691730;323767;314640;3700857;288
ISIC_0012547;100;2;2;1.0;0.6;4288;2848;12212224;0;572681;0;572681;0;572681;83
ISIC_0014623;150;1;2;0.01;0.6;2592;1936;5018112;1713437;640501;1713437;1937167;1296666;2353938;126
ISIC_0014428;50;1;3;0.1;0.6;4288;2848;12212224;3031099;0;3031099;525860;525860;3031099;12
ISIC_0014428;350;3;3;1.0;0.6;4288;2848;12212224;1198099;8354;1198099;525860;517506;1206453;403
ISIC_0008524;100;2;1;1.0;0.6;4288;2848;12212224;5514057;3449;5514057;323767;320318;5517506;78
ISIC_0014712;350;4;2;10.0;0.6;6621;4422;29278062;1244918;18095601;1244918;24292916;6197315;19340519;414
ISIC_0012547;50;1;1;1.0;0.6;4288;2848;12212224;10804739;0;10804739;572681;572681;10804739;3
ISIC_0014712;450;3;3;10.0;0.6;6621;4422;29278062;1061978;18360557;1061978;24292916;5932359;19422535;524
ISIC_0014712;50;1;2;100.0;0.6;6621;4422;29278062;2825609;10386461;2825609;24292916;13906455;13212070;10
ISIC_0013188;100;4;2;0.01;0.6;3008;2000;6016000;4795982;0;4795982;92544;92544;4795982;111
ISIC_0012547;50;1;2;0.1;0.6;4288;2848;12212224;0;572681;0;572681;0;572681;7
ISIC_0007332;250;1;2;1.0;0.6;3024;2016;6096384;5174879;895;5174879;530766;529871;5175774;248
ISIC_0013188;50;1;1;10.0;0.6;3008;2000;6016000;5061945;0;5061945;92544;92544;5061945;4
ISIC_0013082;50;1;1;100.0;0.6;3872;2592;10036224;3808773;0;3808773;254836;254836;3808773;5
ISIC_0012547;200;4;3;1.0;0.6;4288;2848;12212224;11263515;61666;11263515;572681;511015;11325181;238
ISIC_0013188;150;4;3;1.0;0.6;3008;2000;6016000;4436437;0;4436437;92544;92544;4436437;178
ISIC_0008524;450;3;3;10.0;0.6;4288;2848;12212224;3650403;18436;3650403;323767;305331;3668839;524
ISIC_0008524;100;1;2;0.01;0.6;4288;2848;12212224;6158589;2756;6158589;323767;321011;6161345;66
ISIC_0013188;450;2;1;1.0;0.6;3008;2000;6016000;3152389;361;3152389;92544;92183;3152750;498
ISIC_0013188;150;4;2;100.0;0.6;3008;2000;6016000;4436996;0;4436996;92544;92544;4436996;175
ISIC_0013082;250;1;1;1.0;0.6;3872;2592;10036224;2066570;0;2066570;254836;254836;2066570;243
ISIC_0013188;400;1;2;100.0;0.6;3008;2000;6016000;3265173;0;3265173;92544;92544;3265173;430
ISIC_0013128;450;2;1;10.0;0.6;3872;2592;10036224;4668655;0;4668655;470897;470897;4668655;499
ISIC_0013082;250;4;1;100.0;0.6;3872;2592;10036224;2106230;0;2106230;254836;254836;2106230;290
ISIC_0013188;150;3;2;100.0;0.6;3008;2000;6016000;4477347;0;4477347;92544;92544;4477347;160
ISIC_0012547;450;2;2;1.0;0.6;4288;2848;12212224;11253567;54465;11253567;572681;518216;11308032;503
ISIC_0014623;400;2;3;0.1;0.6;2592;1936;5018112;1105963;1085733;1105963;1937167;851434;2191696;447
ISIC_0013082;200;1;1;0.1;0.6;3872;2592;10036224;2215564;1190;2215564;254836;253646;2216754;182
ISIC_0014712;450;4;1;0.01;0.6;6621;4422;29278062;1053813;18772495;1053813;24292916;5520421;19826308;526
ISIC_0012547;200;2;3;100.0;0.6;4288;2848;12212224;11253594;0;11253594;572681;572681;11253594;210
ISIC_0014428;100;4;3;0.01;0.6;4288;2848;12212224;2114661;7430;2114661;525860;518430;2122091;116
ISIC_0008524;100;3;3;1.0;0.6;4288;2848;12212224;5638204;1788;5638204;323767;321979;5639992;103
ISIC_0013128;150;2;2;1.0;0.6;3872;2592;10036224;5812952;0;5812952;470897;470897;5812952;143
ISIC_0003657;50;4;1;10.0;0.6;3024;2016;6096384;2078088;72;2078088;340261;340189;2078160;49
ISIC_0013188;350;1;2;0.01;0.6;3008;2000;6016000;3594554;0;3594554;92544;92544;3594554;366
ISIC_0007332;150;4;3;100.0;0.6;3024;2016;6096384;5525218;0;5525218;530766;530766;5525218;180
ISIC_0007332;300;2;1;0.1;0.6;3024;2016;6096384;5029962;0;5029962;530766;530766;5029962;317
ISIC_0014428;300;1;1;1.0;0.6;4288;2848;12212224;1250974;2220;1250974;525860;523640;1253194;303
ISIC_0014428;300;3;3;1.0;0.6;4288;2848;12212224;1124956;2147;1124956;525860;523713;1127103;343
ISIC_0007332;450;1;3;0.01;0.6;3024;2016;6096384;4493090;7746;4493090;530766;523020;4500836;491
ISIC_0014428;150;1;3;0.01;0.6;4288;2848;12212224;1927022;16731;1927022;525860;509129;1943753;131
ISIC_0013188;400;4;1;0.1;0.6;3008;2000;6016000;3066088;0;3066088;92544;92544;3066088;467
ISIC_0007332;350;3;1;0.1;0.6;3024;2016;6096384;4763248;614;4763248;530766;530152;4763862;392
ISIC_0014623;250;3;1;1.0;0.6;2592;1936;5018112;1187792;1026542;1187792;1937167;910625;2214334;273
ISIC_0013188;400;3;1;10.0;0.6;3008;2000;6016000;3250018;0;3250018;92544;92544;3250018;454
ISIC_0003657;200;1;1;10.0;0.6;3024;2016;6096384;2099397;1525;2099397;340261;338736;2100922;184
ISIC_0013082;100;4;1;0.01;0.6;3872;2592;10036224;3524964;0;3524964;254836;254836;3524964;106
ISIC_0013188;150;3;3;1.0;0.6;3008;2000;6016000;4476882;0;4476882;92544;92544;4476882;163
ISIC_0014428;150;2;2;100.0;0.6;4288;2848;12212224;2072040;990;2072040;525860;524870;2073030;145
ISIC_0007332;450;1;3;1.0;0.6;3024;2016;6096384;4697358;83;4697358;530766;530683;4697441;493
ISIC_0014712;300;3;3;1.0;0.6;6621;4422;29278062;1314378;17477498;1314378;24292916;6815418;18791876;343
ISIC_0013128;100;3;2;0.1;0.6;3872;2592;10036224;6777479;0;6777479;470897;470897;6777479;97
ISIC_0008524;100;4;3;1.0;0.6;4288;2848;12212224;5109449;1728;5109449;323767;322039;5111177;118
ISIC_0012547;150;3;1;0.1;0.6;4288;2848;12212224;11550407;0;11550407;572681;572681;11550407;152
ISIC_0007332;100;4;3;0.1;0.6;3024;2016;6096384;0;530766;0;530766;0;530766;117
ISIC_0013082;50;2;2;10.0;0.6;3872;2592;10036224;3808938;0;3808938;254836;254836;3808938;24
ISIC_0008524;450;1;2;0.01;0.6;4288;2848;12212224;4158652;2793;4158652;323767;320974;4161445;486
ISIC_0007332;450;2;3;0.01;0.6;3024;2016;6096384;4558727;1188;4558727;530766;529578;4559915;506
ISIC_0014712;200;4;3;0.01;0.6;6621;4422;29278062;1489498;17356088;1489498;24292916;6936828;18845586;236
ISIC_0014623;150;1;2;100.0;0.6;2592;1936;5018112;1630316;679463;1630316;1937167;1257704;2309779;130
ISIC_0003657;350;2;2;10.0;0.6;3024;2016;6096384;1646861;2927;1646861;340261;337334;1649788;384
ISIC_0014712;300;4;2;100.0;0.6;6621;4422;29278062;1314378;18365159;1314378;24292916;5927757;19679537;355
ISIC_0014428;100;3;2;1.0;0.6;4288;2848;12212224;2386672;6873;2386672;525860;518987;2393545;98
ISIC_0014623;350;1;1;0.1;0.6;2592;1936;5018112;1181705;973157;1181705;1937167;964010;2154862;362
ISIC_0013188;350;2;1;0.1;0.6;3008;2000;6016000;3351468;0;3351468;92544;92544;3351468;377
ISIC_0003657;250;1;3;10.0;0.6;3024;2016;6096384;2034396;296;2034396;340261;339965;2034692;254
ISIC_0013128;250;3;1;10.0;0.6;3872;2592;10036224;5441595;0;5441595;470897;470897;5441595;274
ISIC_0013188;250;3;2;100.0;0.6;3008;2000;6016000;3820331;0;3820331;92544;92544;3820331;280
ISIC_0012547;350;4;2;10.0;0.6;4288;2848;12212224;11254071;106338;11254071;572681;466343;11360409;414
ISIC_0013128;100;4;3;10.0;0.6;3872;2592;10036224;6459034;0;6459034;470897;470897;6459034;119
ISIC_0014428;100;2;3;100.0;0.6;4288;2848;12212224;2634280;534;2634280;525860;525326;2634814;90
ISIC_0013188;300;2;1;0.1;0.6;3008;2000;6016000;3603900;0;3603900;92544;92544;3603900;317
ISIC_0008524;300;1;3;1.0;0.6;4288;2848;12212224;4449862;11799;4449862;323767;311968;4461661;313
ISIC_0012547;400;1;1;0.01;0.6;4288;2848;12212224;11405065;0;11405065;572681;572681;11405065;421
ISIC_0008524;250;2;2;10.0;0.6;4288;2848;12212224;4539288;7441;4539288;323767;316326;4546729;264
ISIC_0007332;300;2;3;100.0;0.6;3024;2016;6096384;5108871;0;5108871;530766;530766;5108871;330
ISIC_0003657;300;4;3;100.0;0.6;3024;2016;6096384;1540347;2883;1540347;340261;337378;1543230;360
ISIC_0007332;200;3;2;1.0;0.6;3024;2016;6096384;5168590;0;5168590;530766;530766;5168590;218
ISIC_0013188;100;1;1;100.0;0.6;3008;2000;6016000;4864424;0;4864424;92544;92544;4864424;65
ISIC_0014428;150;4;3;0.1;0.6;4288;2848;12212224;1506631;26003;1506631;525860;499857;1532634;177
ISIC_0013188;400;4;2;0.1;0.6;3008;2000;6016000;3114648;0;3114648;92544;92544;3114648;472
ISIC_0003657;100;1;2;100.0;0.6;3024;2016;6096384;2754131;30;2754131;340261;340231;2754161;70
ISIC_0013082;450;1;3;0.01;0.6;3872;2592;10036224;1455371;15745;1455371;254836;239091;1471116;491
ISIC_0014428;350;4;2;10.0;0.6;4288;2848;12212224;1197904;6259;1197904;525860;519601;1204163;414
ISIC_0003657;300;4;3;0.01;0.6;3024;2016;6096384;1468221;26569;1468221;340261;313692;1494790;356
ISIC_0008524;50;1;2;0.1;0.6;4288;2848;12212224;7571014;0;7571014;323767;323767;7571014;7
ISIC_0012547;450;1;2;0.1;0.6;4288;2848;12212224;11259549;29769;11259549;572681;542912;11289318;487
ISIC_0012547;300;3;1;0.1;0.6;4288;2848;12212224;11379806;48352;11379806;572681;524329;11428158;332
ISIC_0014428;350;4;1;1.0;0.6;4288;2848;12212224;1127133;9039;1127133;525860;516821;1136172;408
ISIC_0014428;150;1;1;0.01;0.6;4288;2848;12212224;2218667;0;2218667;525860;525860;2218667;121
ISIC_0013188;200;3;1;100.0;0.6;3008;2000;6016000;4007583;0;4007583;92544;92544;4007583;215
ISIC_0008524;250;4;2;100.0;0.6;4288;2848;12212224;3692084;7441;3692084;323767;316326;3699525;295
ISIC_0014623;50;2;2;100.0;0.6;2592;1936;5018112;2054462;437021;2054462;1937167;1500146;2491483;25
ISIC_0014428;250;3;3;100.0;0.6;4288;2848;12212224;1366468;4628;1366468;525860;521232;1371096;285
ISIC_0014623;400;4;3;10.0;0.6;2592;1936;5018112;976416;1143192;976416;1937167;793975;2119608;479
ISIC_0014712;250;4;2;0.01;0.6;6621;4422;29278062;1810220;18251792;1810220;24292916;6041124;20062012;291
ISIC_0012547;50;4;1;0.01;0.6;4288;2848;12212224;0;572681;0;572681;0;572681;46
ISIC_0014712;450;1;2;10.0;0.6;6621;4422;29278062;1065551;17186282;1065551;24292916;7106634;18251833;489
ISIC_0012547;300;4;1;1.0;0.6;4288;2848;12212224;11303150;163216;11303150;572681;409465;11466366;348
ISIC_0007332;200;2;1;0.1;0.6;3024;2016;6096384;5215990;0;5215990;530766;530766;5215990;197
ISIC_0008524;300;3;3;1.0;0.6;4288;2848;12212224;4306576;1288;4306576;323767;322479;4307864;343
ISIC_0014623;100;3;3;10.0;0.6;2592;1936;5018112;1536427;719447;1536427;1937167;1217720;2255874;104
ISIC_0013188;50;3;1;10.0;0.6;3008;2000;6016000;5061940;0;5061940;92544;92544;5061940;34
ISIC_0013188;50;4;2;10.0;0.6;3008;2000;6016000;4951109;0;4951109;92544;92544;4951109;54
ISIC_0008524;250;2;2;1.0;0.6;4288;2848;12212224;4540201;9274;4540201;323767;314493;4549475;263
ISIC_0013128;450;1;1;0.1;0.6;3872;2592;10036224;4722614;0;4722614;470897;470897;4722614;482
ISIC_0013128;450;3;2;0.1;0.6;3872;2592;10036224;4587994;0;4587994;470897;470897;4587994;517
ISIC_0013128;350;2;2;0.01;0.6;3872;2592;10036224;4968287;0;4968287;470897;470897;4968287;381
ISIC_0013082;200;4;3;0.01;0.6;3872;2592;10036224;2243503;12125;2243503;254836;242711;2255628;236
ISIC_0012547;200;1;3;0.01;0.6;4288;2848;12212224;11548487;0;11548487;572681;572681;11548487;191
ISIC_0013128;400;4;1;0.1;0.6;3872;2592;10036224;4446791;0;4446791;470897;470897;4446791;467
ISIC_0013128;150;1;1;10.0;0.6;3872;2592;10036224;5946325;0;5946325;470897;470897;5946325;124
ISIC_0013188;200;1;3;100.0;0.6;3008;2000;6016000;4007609;0;4007609;92544;92544;4007609;195
ISIC_0012547;150;1;1;1.0;0.6;4288;2848;12212224;11557716;0;11557716;572681;572681;11557716;123
ISIC_0007332;400;3;3;0.01;0.6;3024;2016;6096384;4626346;9751;4626346;530766;521015;4636097;461
ISIC_0007332;450;3;1;0.01;0.6;3024;2016;6096384;4782725;0;4782725;530766;530766;4782725;511
ISIC_0012547;150;4;3;100.0;0.6;4288;2848;12212224;11558318;0;11558318;572681;572681;11558318;180
ISIC_0012547;100;4;3;10.0;0.6;4288;2848;12212224;0;572681;0;572681;0;572681;119
ISIC_0014712;450;1;2;0.01;0.6;6621;4422;29278062;999277;17059873;999277;24292916;7233043;18059150;486
ISIC_0008524;150;1;2;1.0;0.6;4288;2848;12212224;5141670;2599;5141670;323767;321168;5144269;128
ISIC_0013128;100;2;1;0.1;0.6;3872;2592;10036224;6774619;0;6774619;470897;470897;6774619;77
ISIC_0008524;200;1;1;1.0;0.6;4288;2848;12212224;4824919;8114;4824919;323767;315653;4833033;183
ISIC_0014712;400;3;1;0.1;0.6;6621;4422;29278062;1212032;17688748;1212032;24292916;6604168;18900780;452
ISIC_0014623;200;3;3;100.0;0.6;2592;1936;5018112;1235438;918974;1235438;1937167;1018193;2154412;225
ISIC_0014712;400;4;3;100.0;0.6;6621;4422;29278062;1232284;18911066;1232284;24292916;5381850;20143350;480
ISIC_0013128;400;2;1;10.0;0.6;3872;2592;10036224;4607531;0;4607531;470897;470897;4607531;439
ISIC_0008524;100;2;3;10.0;0.6;4288;2848;12212224;5531591;4776;5531591;323767;318991;5536367;89
ISIC_0013082;200;3;2;10.0;0.6;3872;2592;10036224;2123912;200;2123912;254836;254636;2124112;219
ISIC_0008524;100;2;3;0.1;0.6;4288;2848;12212224;5567808;8500;5567808;323767;315267;5576308;87
ISIC_0013188;350;3;3;1.0;0.6;3008;2000;6016000;3526961;0;3526961;92544;92544;3526961;403
ISIC_0013128;450;3;2;1.0;0.6;3872;2592;10036224;4621066;0;4621066;470897;470897;4621066;518
ISIC_0014623;350;2;1;10.0;0.6;2592;1936;5018112;1096027;1040047;1096027;1937167;897120;2136074;379
ISIC_0014623;250;3;2;100.0;0.6;2592;1936;5018112;1187976;1026846;1187976;1937167;910321;2214822;280
ISIC_0013128;200;2;3;100.0;0.6;3872;2592;10036224;5660983;0;5660983;470897;470897;5660983;210
ISIC_0014712;350;4;3;0.1;0.6;6621;4422;29278062;1125042;18545291;1125042;24292916;5747625;19670333;417
ISIC_0014712;250;4;2;1.0;0.6;6621;4422;29278062;1784876;17881873;1784876;24292916;6411043;19666749;293
ISIC_0014623;250;4;3;0.01;0.6;2592;1936;5018112;1090207;1005700;1090207;1937167;931467;2095907;296
ISIC_0013128;100;3;1;1.0;0.6;3872;2592;10036224;6559845;0;6559845;470897;470897;6559845;93
ISIC_0013082;450;2;2;0.01;0.6;3872;2592;10036224;1620196;1431;1620196;254836;253405;1621627;501
ISIC_0007332;200;2;3;10.0;0.6;3024;2016;6096384;5168995;0;5168995;530766;530766;5168995;209
ISIC_0014428;350;4;2;1.0;0.6;4288;2848;12212224;1127217;8964;1127217;525860;516896;1136181;413
ISIC_0014428;300;4;1;1.0;0.6;4288;2848;12212224;1086672;5299;1086672;525860;520561;1091971;348
ISIC_0014712;400;2;3;0.01;0.6;6621;4422;29278062;1034844;17359645;1034844;24292916;6933271;18394489;446
ISIC_0013082;450;4;2;100.0;0.6;3872;2592;10036224;1722804;1608;1722804;254836;253228;1724412;535
ISIC_0014623;150;2;1;10.0;0.6;2592;1936;5018112;1540386;753663;1540386;1937167;1183504;2294049;139
ISIC_0013082;300;3;1;0.01;0.6;3872;2592;10036224;2176137;2472;2176137;254836;252364;2178609;331
ISIC_0013082;400;2;1;10.0;0.6;3872;2592;10036224;1809382;0;1809382;254836;254836;1809382;439
ISIC_0013128;100;4;3;100.0;0.6;3872;2592;10036224;6459034;0;6459034;470897;470897;6459034;120
ISIC_0008524;250;1;3;1.0;0.6;4288;2848;12212224;4539510;8565;4539510;323767;315202;4548075;253
ISIC_0003657;350;4;1;0.1;0.6;3024;2016;6096384;1593008;5328;1593008;340261;334933;1598336;407
ISIC_0014623;350;1;2;100.0;0.6;2592;1936;5018112;1183120;941062;1183120;1937167;996105;2124182;370
ISIC_0013188;250;3;3;1.0;0.6;3008;2000;6016000;3846129;0;3846129;92544;92544;3846129;283
ISIC_0014623;50;1;3;1.0;0.6;2592;1936;5018112;2352767;422864;2352767;1937167;1514303;2775631;13
ISIC_0012547;400;2;1;1.0;0.6;4288;2848;12212224;11219744;0;11219744;572681;572681;11219744;438
ISIC_0013082;350;1;2;100.0;0.6;3872;2592;10036224;1955510;0;1955510;254836;254836;1955510;370
ISIC_0008524;150;2;3;0.1;0.6;4288;2848;12212224;5358106;0;5358106;323767;323767;5358106;147
ISIC_0003657;50;4;3;100.0;0.6;3024;2016;6096384;2078483;72;2078483;340261;340189;2078555;60
ISIC_0012547;300;2;3;100.0;0.6;4288;2848;12212224;11388053;40804;11388053;572681;531877;11428857;330
ISIC_0013082;450;3;3;10.0;0.6;3872;2592;10036224;1722794;1608;1722794;254836;253228;1724402;524
ISIC_0014428;50;3;2;0.01;0.6;4288;2848;12212224;3106188;3029;3106188;525860;522831;3109217;36
ISIC_0012547;400;1;1;0.1;0.6;4288;2848;12212224;11321036;0;11321036;572681;572681;11321036;422
ISIC_0013082;150;4;2;10.0;0.6;3872;2592;10036224;2759696;183;2759696;254836;254653;2759879;174
ISIC_0014428;250;4;1;0.1;0.6;4288;2848;12212224;1231558;0;1231558;525860;525860;1231558;287
ISIC_0007332;100;4;3;0.01;0.6;3024;2016;6096384;0;530766;0;530766;0;530766;116
ISIC_0003657;400;4;1;100.0;0.6;3024;2016;6096384;1481929;3890;1481929;340261;336371;1485819;470
ISIC_0013128;150;3;1;0.1;0.6;3872;2592;10036224;5732419;0;5732419;470897;470897;5732419;152
ISIC_0007332;50;2;2;0.1;0.6;3024;2016;6096384;5243365;0;5243365;530766;530766;5243365;22
ISIC_0013128;350;1;1;0.1;0.6;3872;2592;10036224;5127222;0;5127222;470897;470897;5127222;362
ISIC_0007332;350;1;3;0.1;0.6;3024;2016;6096384;4775551;49;4775551;530766;530717;4775600;372
ISIC_0014623;400;1;3;100.0;0.6;2592;1936;5018112;1185961;966885;1185961;1937167;970282;2152846;435
ISIC_0013128;250;4;1;0.1;0.6;3872;2592;10036224;5350418;0;5350418;470897;470897;5350418;287
ISIC_0007332;150;2;2;10.0;0.6;3024;2016;6096384;5525218;0;5525218;530766;530766;5525218;144
ISIC_0008524;200;3;3;0.01;0.6;4288;2848;12212224;4875340;0;4875340;323767;323767;4875340;221
ISIC_0008524;50;1;1;1.0;0.6;4288;2848;12212224;6140024;13369;6140024;323767;310398;6153393;3
ISIC_0008524;450;4;3;0.1;0.6;4288;2848;12212224;2848523;10537;2848523;323767;313230;2859060;537
ISIC_0012547;250;4;2;1.0;0.6;4288;2848;12212224;11493888;0;11493888;572681;572681;11493888;293
ISIC_0003657;200;2;1;100.0;0.6;3024;2016;6096384;1905638;1525;1905638;340261;338736;1907163;200
ISIC_0012547;50;1;1;0.01;0.6;4288;2848;12212224;0;572681;0;572681;0;572681;1
ISIC_0013082;200;2;3;1.0;0.6;3872;2592;10036224;2130348;503;2130348;254836;254333;2130851;208
ISIC_0014712;350;1;1;10.0;0.6;6621;4422;29278062;1259768;15588932;1259768;24292916;8703984;16848700;364
ISIC_0013188;100;3;3;100.0;0.6;3008;2000;6016000;4801204;0;4801204;92544;92544;4801204;105
ISIC_0008524;450;1;2;1.0;0.6;4288;2848;12212224;4029170;14125;4029170;323767;309642;4043295;488
ISIC_0003657;400;4;1;0.1;0.6;3024;2016;6096384;1521569;0;1521569;340261;340261;1521569;467
ISIC_0007332;400;2;1;1.0;0.6;3024;2016;6096384;4811997;0;4811997;530766;530766;4811997;438
ISIC_0013188;50;1;3;10.0;0.6;3008;2000;6016000;5062080;0;5062080;92544;92544;5062080;14
ISIC_0008524;100;3;3;100.0;0.6;4288;2848;12212224;5531510;4774;5531510;323767;318993;5536284;105
ISIC_0007332;450;3;2;1.0;0.6;3024;2016;6096384;4683759;83;4683759;530766;530683;4683842;518
ISIC_0003657;200;4;2;1.0;0.6;3024;2016;6096384;1693946;901;1693946;340261;339360;1694847;233
ISIC_0014623;150;3;3;0.1;0.6;2592;1936;5018112;1357966;905624;1357966;1937167;1031543;2263590;162
ISIC_0008524;100;2;2;0.1;0.6;4288;2848;12212224;5565565;7915;5565565;323767;315852;5573480;82
ISIC_0013188;350;3;2;1.0;0.6;3008;2000;6016000;3507849;0;3507849;92544;92544;3507849;398
ISIC_0014428;300;4;3;0.1;0.6;4288;2848;12212224;1180944;1318;1180944;525860;524542;1182262;357
ISIC_0013082;100;3;2;100.0;0.6;3872;2592;10036224;2998280;0;2998280;254836;254836;2998280;100
ISIC_0013188;300;2;3;10.0;0.6;3008;2000;6016000;3696166;45;3696166;92544;92499;3696211;329
ISIC_0013082;450;2;2;1.0;0.6;3872;2592;10036224;1785340;0;1785340;254836;254836;1785340;503
ISIC_0013188;250;3;2;10.0;0.6;3008;2000;6016000;3820182;0;3820182;92544;92544;3820182;279
ISIC_0012547;400;1;1;1.0;0.6;4288;2848;12212224;11250255;0;11250255;572681;572681;11250255;423
ISIC_0014712;400;3;3;0.01;0.6;6621;4422;29278062;1032545;17546783;1032545;24292916;6746133;18579328;461
ISIC_0013082;100;2;3;0.1;0.6;3872;2592;10036224;3004001;15152;3004001;254836;239684;3019153;87
ISIC_0003657;50;1;1;100.0;0.6;3024;2016;6096384;2884232;72;2884232;340261;340189;2884304;5
ISIC_0012547;150;1;1;0.01;0.6;4288;2848;12212224;0;572681;0;572681;0;572681;121
ISIC_0014712;400;2;3;10.0;0.6;6621;4422;29278062;1315891;17585942;1315891;24292916;6706974;18901833;449
ISIC_0014428;250;2;3;10.0;0.6;4288;2848;12212224;1366468;4628;1366468;525860;521232;1371096;269
ISIC_0014712;100;2;2;1.0;0.6;6621;4422;29278062;3327063;12127159;3327063;24292916;12165757;15454222;83
ISIC_0013128;50;2;3;1.0;0.6;3872;2592;10036224;6961170;0;6961170;470897;470897;6961170;28
ISIC_0007332;450;1;1;10.0;0.6;3024;2016;6096384;4697242;83;4697242;530766;530683;4697325;484
ISIC_0013188;350;4;2;0.1;0.6;3008;2000;6016000;3371245;0;3371245;92544;92544;3371245;412
ISIC_0003657;400;2;2;1.0;0.6;3024;2016;6096384;1609868;4147;1609868;340261;336114;1614015;443
ISIC_0008524;450;4;2;1.0;0.6;4288;2848;12212224;2777132;21923;2777132;323767;301844;2799055;533
ISIC_0012547;450;4;2;10.0;0.6;4288;2848;12212224;11029056;108900;11029056;572681;463781;11137956;534
ISIC_0008524;300;4;3;1.0;0.6;4288;2848;12212224;3703798;981;3703798;323767;322786;3704779;358
ISIC_0013082;200;3;2;0.01;0.6;3872;2592;10036224;2482190;0;2482190;254836;254836;2482190;216
ISIC_0008524;400;2;3;10.0;0.6;4288;2848;12212224;3997142;13085;3997142;323767;310682;4010227;449
ISIC_0007332;300;2;2;1.0;0.6;3024;2016;6096384;5088339;0;5088339;530766;530766;5088339;323
ISIC_0014623;300;2;3;1.0;0.6;2592;1936;5018112;1114227;1061439;1114227;1937167;875728;2175666;328
ISIC_0008524;50;4;3;10.0;0.6;4288;2848;12212224;5717563;11966;5717563;323767;311801;5729529;59
ISIC_0007332;50;1;2;0.1;0.6;3024;2016;6096384;5351784;0;5351784;530766;530766;5351784;7
ISIC_0014623;150;2;1;1.0;0.6;2592;1936;5018112;1540743;753300;1540743;1937167;1183867;2294043;138
ISIC_0013082;400;4;1;0.01;0.6;3872;2592;10036224;1742013;28;1742013;254836;254808;1742041;466
ISIC_0013128;400;4;2;10.0;0.6;3872;2592;10036224;4483558;0;4483558;470897;470897;4483558;474
ISIC_0014623;250;4;3;100.0;0.6;2592;1936;5018112;1086075;1047010;1086075;1937167;890157;2133085;300
ISIC_0013188;50;4;1;100.0;0.6;3008;2000;6016000;4950968;0;4950968;92544;92544;4950968;50
ISIC_0008524;400;2;1;10.0;0.6;4288;2848;12212224;3997306;13085;3997306;323767;310682;4010391;439
ISIC_0014623;300;2;1;1.0;0.6;2592;1936;5018112;1114332;1061568;1114332;1937167;875599;2175900;318
ISIC_0014623;400;3;3;1.0;0.6;2592;1936;5018112;1009714;1099988;1009714;1937167;837179;2109702;463
ISIC_0013128;150;1;2;1.0;0.6;3872;2592;10036224;5945921;0;5945921;470897;470897;5945921;128
ISIC_0014428;250;3;1;1.0;0.6;4288;2848;12212224;1364324;0;1364324;525860;525860;1364324;273
ISIC_0008524;450;1;3;10.0;0.6;4288;2848;12212224;4007581;18436;4007581;323767;305331;4026017;494
ISIC_0014428;50;3;3;100.0;0.6;4288;2848;12212224;2715318;1211;2715318;525860;524649;2716529;45
ISIC_0014623;300;3;1;0.1;0.6;2592;1936;5018112;1074211;1096369;1074211;1937167;840798;2170580;332
ISIC_0013128;50;4;3;0.1;0.6;3872;2592;10036224;6956998;0;6956998;470897;470897;6956998;57
ISIC_0014623;50;1;3;0.01;0.6;2592;1936;5018112;2423035;260981;2423035;1937167;1676186;2684016;11
ISIC_0013188;100;1;1;1.0;0.6;3008;2000;6016000;4863538;0;4863538;92544;92544;4863538;63
ISIC_0013082;150;1;1;0.1;0.6;3872;2592;10036224;2488856;0;2488856;254836;254836;2488856;122
ISIC_0013082;200;2;3;0.1;0.6;3872;2592;10036224;2139340;1595;2139340;254836;253241;2140935;207
ISIC_0003657;450;2;2;10.0;0.6;3024;2016;6096384;1551054;1807;1551054;340261;338454;1552861;504
ISIC_0013082;400;1;2;0.01;0.6;3872;2592;10036224;1540066;3180;1540066;254836;251656;1543246;426
ISIC_0013128;250;3;1;100.0;0.6;3872;2592;10036224;5441595;0;5441595;470897;470897;5441595;275
ISIC_0003657;300;4;1;1.0;0.6;3024;2016;6096384;1540028;3130;1540028;340261;337131;1543158;348
ISIC_0014623;50;2;1;10.0;0.6;2592;1936;5018112;2054593;437009;2054593;1937167;1500158;2491602;19
ISIC_0014623;400;2;1;0.1;0.6;2592;1936;5018112;1103342;1086903;1103342;1937167;850264;2190245;437
ISIC_0013128;50;1;2;10.0;0.6;3872;2592;10036224;6971240;0;6971240;470897;470897;6971240;9
ISIC_0007332;300;1;2;10.0;0.6;3024;2016;6096384;5087998;0;5087998;530766;530766;5087998;309
ISIC_0012547;350;3;1;0.1;0.6;4288;2848;12212224;11270165;38854;11270165;572681;533827;11309019;392
ISIC_0008524;450;3;3;1.0;0.6;4288;2848;12212224;3671194;14442;3671194;323767;309325;3685636;523
ISIC_0013188;350;2;2;10.0;0.6;3008;2000;6016000;3509675;0;3509675;92544;92544;3509675;384
ISIC_0008524;50;4;1;100.0;0.6;4288;2848;12212224;5718095;11966;5718095;323767;311801;5730061;50
ISIC_0008524;350;1;1;1.0;0.6;4288;2848;12212224;4208929;3121;4208929;323767;320646;4212050;363
ISIC_0014428;100;3;3;0.01;0.6;4288;2848;12212224;2251614;7509;2251614;525860;518351;2259123;101
ISIC_0003657;150;2;3;1.0;0.6;3024;2016;6096384;2253973;2034;2253973;340261;338227;2256007;148
ISIC_0014623;50;3;3;10.0;0.6;2592;1936;5018112;2054894;436469;2054894;1937167;1500698;2491363;44
ISIC_0013128;50;2;3;10.0;0.6;3872;2592;10036224;6971246;0;6971246;470897;470897;6971246;29
ISIC_0013128;50;3;2;1.0;0.6;3872;2592;10036224;6972506;0;6972506;470897;470897;6972506;38
ISIC_0013128;300;2;1;100.0;0.6;3872;2592;10036224;5142267;39;5142267;470897;470858;5142306;320
ISIC_0012547;350;3;2;1.0;0.6;4288;2848;12212224;11254463;71369;11254463;572681;501312;11325832;398
ISIC_0013128;100;3;3;1.0;0.6;3872;2592;10036224;6559628;0;6559628;470897;470897;6559628;103
ISIC_0013188;250;3;1;0.1;0.6;3008;2000;6016000;3727071;0;3727071;92544;92544;3727071;272
ISIC_0013128;450;4;3;10.0;0.6;3872;2592;10036224;4438033;0;4438033;470897;470897;4438033;539
ISIC_0014623;100;4;2;0.1;0.6;2592;1936;5018112;1702346;703131;1702346;1937167;1234036;2405477;112
ISIC_0014428;150;2;1;0.1;0.6;4288;2848;12212224;1833715;0;1833715;525860;525860;1833715;137
ISIC_0008524;100;1;1;0.01;0.6;4288;2848;12212224;6149787;1917;6149787;323767;321850;6151704;61
ISIC_0013128;150;3;3;100.0;0.6;3872;2592;10036224;5745378;0;5745378;470897;470897;5745378;165
ISIC_0014712;50;3;2;100.0;0.6;6621;4422;29278062;2849636;13299682;2849636;24292916;10993234;16149318;40
ISIC_0008524;400;4;3;100.0;0.6;4288;2848;12212224;3131166;13085;3131166;323767;310682;3144251;480
ISIC_0013082;400;1;1;0.01;0.6;3872;2592;10036224;1673192;0;1673192;254836;254836;1673192;421
ISIC_0007332;150;2;2;0.01;0.6;3024;2016;6096384;5525084;0;5525084;530766;530766;5525084;141
ISIC_0013128;350;1;2;10.0;0.6;3872;2592;10036224;5025736;0;5025736;470897;470897;5025736;369
ISIC_0014623;450;1;2;10.0;0.6;2592;1936;5018112;1111293;1023045;1111293;1937167;914122;2134338;489
ISIC_0014623;400;4;1;1.0;0.6;2592;1936;5018112;976761;1142768;976761;1937167;794399;2119529;468
ISIC_0014712;150;4;2;100.0;0.6;6621;4422;29278062;1799378;16333380;1799378;24292916;7959536;18132758;175
ISIC_0008524;450;1;2;100.0;0.6;4288;2848;12212224;4007581;18436;4007581;323767;305331;4026017;490
ISIC_0013082;100;4;3;100.0;0.6;3872;2592;10036224;2998256;0;2998256;254836;254836;2998256;120
ISIC_0013188;100;3;2;0.1;0.6;3008;2000;6016000;4925530;0;4925530;92544;92544;4925530;97
ISIC_0013188;300;4;1;100.0;0.6;3008;2000;6016000;3655663;45;3655663;92544;92499;3655708;350
ISIC_0012547;100;1;1;1.0;0.6;4288;2848;12212224;0;572681;0;572681;0;572681;63
ISIC_0012547;200;4;1;10.0;0.6;4288;2848;12212224;11253233;61009;11253233;572681;511672;11314242;229
ISIC_0003657;300;1;3;100.0;0.6;3024;2016;6096384;1919064;2337;1919064;340261;337924;1921401;315
ISIC_0014623;150;2;3;1.0;0.6;2592;1936;5018112;1568560;753434;1568560;1937167;1183733;2321994;148
ISIC_0013188;250;1;2;0.1;0.6;3008;2000;6016000;3756043;0;3756043;92544;92544;3756043;247
ISIC_0008524;100;4;1;0.1;0.6;4288;2848;12212224;5301792;5026;5301792;323767;318741;5306818;107
ISIC_0014428;100;1;2;0.1;0.6;4288;2848;12212224;2420309;0;2420309;525860;525860;2420309;67
ISIC_0014428;300;4;1;0.01;0.6;4288;2848;12212224;1423813;435;1423813;525860;525425;1424248;346
ISIC_0008524;100;3;2;0.1;0.6;4288;2848;12212224;5694487;5402;5694487;323767;318365;5699889;97
ISIC_0013082;50;4;3;100.0;0.6;3872;2592;10036224;3808844;0;3808844;254836;254836;3808844;60
ISIC_0013082;400;2;2;10.0;0.6;3872;2592;10036224;1809385;0;1809385;254836;254836;1809385;444
ISIC_0013128;100;1;2;0.01;0.6;3872;2592;10036224;6786992;0;6786992;470897;470897;6786992;66
ISIC_0013128;400;4;3;0.01;0.6;3872;2592;10036224;4539241;0;4539241;470897;470897;4539241;476
ISIC_0013128;250;3;3;0.1;0.6;3872;2592;10036224;5445613;0;5445613;470897;470897;5445613;282
ISIC_0013128;300;2;3;1.0;0.6;3872;2592;10036224;5142211;55;5142211;470897;470842;5142266;328
ISIC_0014428;250;3;3;10.0;0.6;4288;2848;12212224;1366468;4628;1366468;525860;521232;1371096;284
ISIC_0013188;450;3;1;10.0;0.6;3008;2000;6016000;3126231;0;3126231;92544;92544;3126231;514
ISIC_0014428;50;2;1;100.0;0.6;4288;2848;12212224;2715664;1211;2715664;525860;524649;2716875;20
ISIC_0013188;150;2;2;10.0;0.6;3008;2000;6016000;4477530;0;4477530;92544;92544;4477530;144
ISIC_0013082;100;3;3;100.0;0.6;3872;2592;10036224;2998256;0;2998256;254836;254836;2998256;105
ISIC_0014428;200;1;1;10.0;0.6;4288;2848;12212224;1568841;999;1568841;525860;524861;1569840;184
ISIC_0014712;400;4;2;100.0;0.6;6621;4422;29278062;1232291;18911029;1232291;24292916;5381887;20143320;475
ISIC_0014623;200;4;1;0.01;0.6;2592;1936;5018112;1187773;959765;1187773;1937167;977402;2147538;226
ISIC_0014623;300;1;1;0.01;0.6;2592;1936;5018112;1292856;879031;1292856;1937167;1058136;2171887;301
ISIC_0008524;50;4;2;10.0;0.6;4288;2848;12212224;5717589;11966;5717589;323767;311801;5729555;54
ISIC_0014428;250;2;2;0.01;0.6;4288;2848;12212224;1266996;0;1266996;525860;525860;1266996;261
ISIC_0007332;200;3;3;1.0;0.6;3024;2016;6096384;5168503;0;5168503;530766;530766;5168503;223
ISIC_0014623;350;2;1;0.01;0.6;2592;1936;5018112;1120836;1039884;1120836;1937167;897283;2160720;376
ISIC_0012547;450;3;3;0.1;0.6;4288;2848;12212224;11209915;57718;11209915;572681;514963;11267633;522
ISIC_0014428;400;2;1;0.01;0.6;4288;2848;12212224;1134163;5719;1134163;525860;520141;1139882;436
ISIC_0014623;300;3;2;10.0;0.6;2592;1936;5018112;1080816;1094721;1080816;1937167;842446;2175537;339
ISIC_0012547;50;4;3;0.01;0.6;4288;2848;12212224;0;572681;0;572681;0;572681;56
ISIC_0008524;50;2;2;0.1;0.6;4288;2848;12212224;7151338;0;7151338;323767;323767;7151338;22
ISIC_0012547;300;2;1;10.0;0.6;4288;2848;12212224;11388053;40804;11388053;572681;531877;11428857;319
ISIC_0007332;350;3;1;10.0;0.6;3024;2016;6096384;4871959;0;4871959;530766;530766;4871959;394
ISIC_0013188;450;3;1;0.1;0.6;3008;2000;6016000;3133748;0;3133748;92544;92544;3133748;512
ISIC_0008524;250;4;3;10.0;0.6;4288;2848;12212224;3692084;7441;3692084;323767;316326;3699525;299
ISIC_0003657;400;1;3;100.0;0.6;3024;2016;6096384;1781211;3890;1781211;340261;336371;1785101;435
ISIC_0003657;100;1;3;0.1;0.6;3024;2016;6096384;2853744;0;2853744;340261;340261;2853744;72
ISIC_0012547;300;2;1;1.0;0.6;4288;2848;12212224;11387923;40582;11387923;572681;532099;11428505;318
ISIC_0014712;250;4;2;10.0;0.6;6621;4422;29278062;1784886;17882237;1784886;24292916;6410679;19667123;294
ISIC_0008524;100;1;3;0.1;0.6;4288;2848;12212224;5699458;14185;5699458;323767;309582;5713643;72
ISIC_0014428;100;3;3;1.0;0.6;4288;2848;12212224;2386620;6806;2386620;525860;519054;2393426;103
ISIC_0007332;450;1;2;0.01;0.6;3024;2016;6096384;4598552;0;4598552;530766;530766;4598552;486
ISIC_0003657;250;2;3;10.0;0.6;3024;2016;6096384;1824931;296;1824931;340261;339965;1825227;269
ISIC_0014712;150;4;2;10.0;0.6;6621;4422;29278062;1799378;16333380;1799378;24292916;7959536;18132758;174
ISIC_0013082;400;4;1;1.0;0.6;3872;2592;10036224;1814116;0;1814116;254836;254836;1814116;468
ISIC_0014428;300;1;3;0.1;0.6;4288;2848;12212224;1283951;961;1283951;525860;524899;1284912;312
ISIC_0013082;100;4;2;100.0;0.6;3872;2592;10036224;2998280;0;2998280;254836;254836;2998280;115
ISIC_0003657;250;1;3;100.0;0.6;3024;2016;6096384;2034411;296;2034411;340261;339965;2034707;255
ISIC_0014712;50;3;1;10.0;0.6;6621;4422;29278062;2464669;12862513;2464669;24292916;11430403;15327182;34
ISIC_0013128;400;1;3;10.0;0.6;3872;2592;10036224;4736367;0;4736367;470897;470897;4736367;434
ISIC_0013128;250;3;1;0.1;0.6;3872;2592;10036224;5479749;0;5479749;470897;470897;5479749;272
ISIC_0013082;150;3;3;0.1;0.6;3872;2592;10036224;2850177;314;2850177;254836;254522;2850491;162
ISIC_0014712;450;2;1;0.1;0.6;6621;4422;29278062;956897;18280051;956897;24292916;6012865;19236948;497
ISIC_0003657;350;4;3;0.1;0.6;3024;2016;6096384;1605282;0;1605282;340261;340261;1605282;417
ISIC_0013188;350;1;1;10.0;0.6;3008;2000;6016000;3526828;0;3526828;92544;92544;3526828;364
ISIC_0013082;100;1;2;10.0;0.6;3872;2592;10036224;3104054;0;3104054;254836;254836;3104054;69
ISIC_0012547;150;2;1;0.1;0.6;4288;2848;12212224;11548487;0;11548487;572681;572681;11548487;137
ISIC_0013082;400;3;2;100.0;0.6;3872;2592;10036224;1834505;0;1834505;254836;254836;1834505;460
ISIC_0003657;350;1;2;0.01;0.6;3024;2016;6096384;1869010;12130;1869010;340261;328131;1881140;366
ISIC_0013188;100;4;3;0.01;0.6;3008;2000;6016000;4781764;0;4781764;92544;92544;4781764;116
ISIC_0014623;200;1;3;0.1;0.6;2592;1936;5018112;1385135;788957;1385135;1937167;1148210;2174092;192
ISIC_0012547;350;3;1;1.0;0.6;4288;2848;12212224;11254481;71369;11254481;572681;501312;11325850;393
ISIC_0012547;250;4;3;100.0;0.6;4288;2848;12212224;11494346;0;11494346;572681;572681;11494346;300
ISIC_0014712;350;4;2;100.0;0.6;6621;4422;29278062;1244918;18095601;1244918;24292916;6197315;19340519;415
ISIC_0014712;300;4;3;100.0;0.6;6621;4422;29278062;1314378;18364846;1314378;24292916;5928070;19679224;360
ISIC_0012547;350;3;3;100.0;0.6;4288;2848;12212224;11254071;71369;11254071;572681;501312;11325440;405
ISIC_0014712;150;3;1;0.01;0.6;6621;4422;29278062;1891175;14549354;1891175;24292916;9743562;16440529;151
ISIC_0014428;200;4;1;1.0;0.6;4288;2848;12212224;1226091;3356;1226091;525860;522504;1229447;228
ISIC_0003657;400;4;2;1.0;0.6;3024;2016;6096384;1482122;4151;1482122;340261;336110;1486273;473
ISIC_0013082;100;3;2;0.01;0.6;3872;2592;10036224;3266438;17516;3266438;254836;237320;3283954;96
ISIC_0013082;50;1;3;1.0;0.6;3872;2592;10036224;3806611;0;3806611;254836;254836;3806611;13
ISIC_0013188;450;3;2;0.1;0.6;3008;2000;6016000;3076527;0;3076527;92544;92544;3076527;517
ISIC_0013082;350;3;2;0.1;0.6;3872;2592;10036224;1702405;2212;1702405;254836;252624;1704617;397
ISIC_0014623;300;3;3;1.0;0.6;2592;1936;5018112;1080990;1094711;1080990;1937167;842456;2175701;343
ISIC_0003657;400;3;2;0.1;0.6;3024;2016;6096384;1580071;0;1580071;340261;340261;1580071;457
ISIC_0007332;200;1;3;0.01;0.6;3024;2016;6096384;5203178;0;5203178;530766;530766;5203178;191
ISIC_0014712;200;4;1;0.1;0.6;6621;4422;29278062;1344562;17792384;1344562;24292916;6500532;19136946;227
ISIC_0008524;400;3;3;0.1;0.6;4288;2848;12212224;4000802;3563;4000802;323767;320204;4004365;462
ISIC_0013188;50;4;1;0.01;0.6;3008;2000;6016000;5535095;0;5535095;92544;92544;5535095;46
ISIC_0014623;200;3;2;10.0;0.6;2592;1936;5018112;1235441;918981;1235441;1937167;1018186;2154422;219
ISIC_0013188;350;3;3;0.01;0.6;3008;2000;6016000;3492378;0;3492378;92544;92544;3492378;401
ISIC_0007332;150;1;3;100.0;0.6;3024;2016;6096384;5525218;0;5525218;530766;530766;5525218;135
ISIC_0014623;350;1;2;0.1;0.6;2592;1936;5018112;1152393;945761;1152393;1937167;991406;2098154;367
ISIC_0014712;350;2;2;0.1;0.6;6621;4422;29278062;1138016;17189612;1138016;24292916;7103304;18327628;382
ISIC_0013188;300;1;3;0.1;0.6;3008;2000;6016000;3720704;0;3720704;92544;92544;3720704;312
ISIC_0012547;50;3;2;100.0;0.6;4288;2848;12212224;10811912;0;10811912;572681;572681;10811912;40
ISIC_0012547;150;4;2;1.0;0.6;4288;2848;12212224;11558220;0;11558220;572681;572681;11558220;173
ISIC_0014428;100;3;2;10.0;0.6;4288;2848;12212224;2512698;534;2512698;525860;525326;2513232;99
ISIC_0007332;350;4;3;100.0;0.6;3024;2016;6096384;4854540;0;4854540;530766;530766;4854540;420
ISIC_0012547;400;2;3;0.01;0.6;4288;2848;12212224;11386745;0;11386745;572681;572681;11386745;446
ISIC_0012547;50;3;1;1.0;0.6;4288;2848;12212224;10798235;0;10798235;572681;572681;10798235;33
ISIC_0014428;50;1;2;0.01;0.6;4288;2848;12212224;3526808;5067;3526808;525860;520793;3531875;6
ISIC_0013188;150;2;1;0.1;0.6;3008;2000;6016000;4359215;0;4359215;92544;92544;4359215;137
ISIC_0013082;350;2;1;0.1;0.6;3872;2592;10036224;1686278;4745;1686278;254836;250091;1691023;377
ISIC_0007332;50;3;1;0.01;0.6;3024;2016;6096384;0;530766;0;530766;0;530766;31
ISIC_0012547;100;4;1;10.0;0.6;4288;2848;12212224;0;572681;0;572681;0;572681;109
ISIC_0014623;350;4;3;0.01;0.6;2592;1936;5018112;952989;1148470;952989;1937167;788697;2101459;416
ISIC_0008524;300;2;2;0.1;0.6;4288;2848;12212224;4403983;5401;4403983;323767;318366;4409384;322
ISIC_0007332;250;1;3;0.01;0.6;3024;2016;6096384;5106119;4785;5106119;530766;525981;5110904;251
ISIC_0013188;450;3;3;100.0;0.6;3008;2000;6016000;3126271;0;3126271;92544;92544;3126271;525
ISIC_0014623;400;3;2;0.1;0.6;2592;1936;5018112;1012142;1118415;1012142;1937167;818752;2130557;457
ISIC_0014623;100;4;3;10.0;0.6;2592;1936;5018112;1496825;767923;1496825;1937167;1169244;2264748;119
ISIC_0014712;450;3;3;1.0;0.6;6621;4422;29278062;1061947;18360304;1061947;24292916;5932612;19422251;523
ISIC_0012547;100;2;3;0.01;0.6;4288;2848;12212224;0;572681;0;572681;0;572681;86
ISIC_0008524;300;1;1;0.01;0.6;4288;2848;12212224;4536141;0;4536141;323767;323767;4536141;301
ISIC_0012547;150;2;3;100.0;0.6;4288;2848;12212224;11558318;0;11558318;572681;572681;11558318;150
ISIC_0007332;100;2;1;0.01;0.6;3024;2016;6096384;0;530766;0;530766;0;530766;76
ISIC_0007332;150;3;3;1.0;0.6;3024;2016;6096384;5525218;0;5525218;530766;530766;5525218;163
ISIC_0008524;400;1;3;10.0;0.6;4288;2848;12212224;4134861;13085;4134861;323767;310682;4147946;434
ISIC_0003657;300;1;2;1.0;0.6;3024;2016;6096384;1919542;2814;1919542;340261;337447;1922356;308
ISIC_0008524;100;3;2;1.0;0.6;4288;2848;12212224;5637926;1785;5637926;323767;321982;5639711;98
ISIC_0007332;300;2;2;100.0;0.6;3024;2016;6096384;5108871;0;5108871;530766;530766;5108871;325
ISIC_0012547;200;4;2;0.1;0.6;4288;2848;12212224;11512413;75472;11512413;572681;497209;11587885;232
ISIC_0007332;50;2;1;100.0;0.6;3024;2016;6096384;5139556;0;5139556;530766;530766;5139556;20
ISIC_0012547;200;4;1;0.1;0.6;4288;2848;12212224;11511522;75583;11511522;572681;497098;11587105;227
ISIC_0014712;450;2;1;1.0;0.6;6621;4422;29278062;1061952;18096379;1061952;24292916;6196537;19158331;498
ISIC_0003657;350;1;3;100.0;0.6;3024;2016;6096384;1804735;2927;1804735;340261;337334;1807662;375
ISIC_0007332;250;4;2;10.0;0.6;3024;2016;6096384;5150286;895;5150286;530766;529871;5151181;294
ISIC_0013128;350;4;2;100.0;0.6;3872;2592;10036224;4753804;0;4753804;470897;470897;4753804;415
ISIC_0008524;300;4;2;10.0;0.6;4288;2848;12212224;3661616;4070;3661616;323767;319697;3665686;354
ISIC_0003657;200;3;1;0.01;0.6;3024;2016;6096384;2111868;0;2111868;340261;340261;2111868;211
ISIC_0013188;300;4;1;1.0;0.6;3008;2000;6016000;3635586;32;3635586;92544;92512;3635618;348
ISIC_0014712;400;1;3;0.1;0.6;6621;4422;29278062;1370745;16653033;1370745;24292916;7639883;18023778;432
ISIC_0007332;300;1;1;10.0;0.6;3024;2016;6096384;5088139;0;5088139;530766;530766;5088139;304
ISIC_0008524;150;4;2;100.0;0.6;4288;2848;12212224;4172718;5649;4172718;323767;318118;4178367;175
ISIC_0007332;450;1;2;100.0;0.6;3024;2016;6096384;4697322;83;4697322;530766;530683;4697405;490
ISIC_0014712;400;1;2;0.1;0.6;6621;4422;29278062;1370251;16581422;1370251;24292916;7711494;17951673;427
ISIC_0014712;200;1;2;10.0;0.6;6621;4422;29278062;1419760;14624012;1419760;24292916;9668904;16043772;189
ISIC_0008524;300;4;3;10.0;0.6;4288;2848;12212224;3661439;4070;3661439;323767;319697;3665509;359
ISIC_0013082;400;3;1;0.01;0.6;3872;2592;10036224;1714378;9;1714378;254836;254827;1714387;451
ISIC_0013082;50;4;2;10.0;0.6;3872;2592;10036224;3809107;0;3809107;254836;254836;3809107;54
ISIC_0014623;250;1;2;0.01;0.6;2592;1936;5018112;1396775;818390;1396775;1937167;1118777;2215165;246
ISIC_0008524;50;2;3;1.0;0.6;4288;2848;12212224;6143521;13834;6143521;323767;309933;6157355;28
ISIC_0014623;250;2;2;10.0;0.6;2592;1936;5018112;1266678;966718;1266678;1937167;970449;2233396;264
ISIC_0014428;100;3;3;0.1;0.6;4288;2848;12212224;2051301;6;2051301;525860;525854;2051307;102
ISIC_0003657;150;4;2;0.01;0.6;3024;2016;6096384;1880930;19791;1880930;340261;320470;1900721;171
ISIC_0014623;100;2;3;1.0;0.6;2592;1936;5018112;1621465;624451;1621465;1937167;1312716;2245916;88
ISIC_0014712;50;1;3;0.01;0.6;6621;4422;29278062;3959342;9596030;3959342;24292916;14696886;13555372;11
ISIC_0013188;250;1;1;10.0;0.6;3008;2000;6016000;3844362;0;3844362;92544;92544;3844362;244
ISIC_0003657;50;3;3;1.0;0.6;3024;2016;6096384;2300548;56;2300548;340261;340205;2300604;43
ISIC_0008524;450;4;2;10.0;0.6;4288;2848;12212224;2777495;18436;2777495;323767;305331;2795931;534
ISIC_0013188;250;1;1;1.0;0.6;3008;2000;6016000;3822181;0;3822181;92544;92544;3822181;243
ISIC_0013188;100;3;2;10.0;0.6;3008;2000;6016000;4801202;0;4801202;92544;92544;4801202;99
ISIC_0008524;350;2;3;10.0;0.6;4288;2848;12212224;3998569;277;3998569;323767;323490;3998846;389
ISIC_0013188;300;3;2;0.1;0.6;3008;2000;6016000;3650648;1178;3650648;92544;91366;3651826;337
ISIC_0014712;200;1;1;10.0;0.6;6621;4422;29278062;1419760;14624016;1419760;24292916;9668900;16043776;184
ISIC_0014428;200;2;2;0.1;0.6;4288;2848;12212224;1617194;0;1617194;525860;525860;1617194;202
ISIC_0014428;300;4;2;0.01;0.6;4288;2848;12212224;1296755;697;1296755;525860;525163;1297452;351
ISIC_0008524;350;2;2;0.01;0.6;4288;2848;12212224;4142429;4659;4142429;323767;319108;4147088;381
ISIC_0008524;150;1;3;100.0;0.6;4288;2848;12212224;4994089;5649;4994089;323767;318118;4999738;135
ISIC_0013188;350;4;3;1.0;0.6;3008;2000;6016000;3508640;0;3508640;92544;92544;3508640;418
ISIC_0013188;350;1;1;100.0;0.6;3008;2000;6016000;3526828;0;3526828;92544;92544;3526828;365
ISIC_0013082;150;1;3;1.0;0.6;3872;2592;10036224;2690903;1539;2690903;254836;253297;2692442;133
ISIC_0013082;100;4;1;100.0;0.6;3872;2592;10036224;2998289;0;2998289;254836;254836;2998289;110
ISIC_0007332;150;1;3;0.01;0.6;3024;2016;6096384;5451848;2670;5451848;530766;528096;5454518;131
ISIC_0014428;50;4;1;100.0;0.6;4288;2848;12212224;2715664;1211;2715664;525860;524649;2716875;50
ISIC_0013128;400;2;2;100.0;0.6;3872;2592;10036224;4607544;0;4607544;470897;470897;4607544;445
ISIC_0013082;150;3;1;10.0;0.6;3872;2592;10036224;2759695;183;2759695;254836;254653;2759878;154
ISIC_0014428;200;1;1;0.1;0.6;4288;2848;12212224;1726692;0;1726692;525860;525860;1726692;182
ISIC_0003657;50;4;2;0.01;0.6;3024;2016;6096384;3114873;1800;3114873;340261;338461;3116673;51
ISIC_0003657;350;1;2;0.1;0.6;3024;2016;6096384;1874000;0;1874000;340261;340261;1874000;367
ISIC_0007332;250;3;2;1.0;0.6;3024;2016;6096384;5150167;895;5150167;530766;529871;5151062;278
ISIC_0008524;200;3;3;1.0;0.6;4288;2848;12212224;4644080;10352;4644080;323767;313415;4654432;223
ISIC_0014428;150;1;2;1.0;0.6;4288;2848;12212224;2149384;0;2149384;525860;525860;2149384;128
ISIC_0013082;200;4;1;100.0;0.6;3872;2592;10036224;2123932;200;2123932;254836;254636;2124132;230
ISIC_0014428;150;4;3;10.0;0.6;4288;2848;12212224;1828088;990;1828088;525860;524870;1829078;179
ISIC_0014428;450;4;2;10.0;0.6;4288;2848;12212224;1128313;8163;1128313;525860;517697;1136476;534
ISIC_0003657;50;1;2;0.01;0.6;3024;2016;6096384;4035037;5384;4035037;340261;334877;4040421;6
ISIC_0012547;100;1;3;1.0;0.6;4288;2848;12212224;0;572681;0;572681;0;572681;73
ISIC_0013128;150;2;1;10.0;0.6;3872;2592;10036224;5812685;0;5812685;470897;470897;5812685;139
ISIC_0013128;100;4;3;0.01;0.6;3872;2592;10036224;6625040;0;6625040;470897;470897;6625040;116
ISIC_0014712;100;1;3;1.0;0.6;6621;4422;29278062;3652544;10959774;3652544;24292916;13333142;14612318;73
ISIC_0014623;150;1;2;0.1;0.6;2592;1936;5018112;1625980;772015;1625980;1937167;1165152;2397995;127
ISIC_0014428;200;2;3;1.0;0.6;4288;2848;12212224;1399139;3130;1399139;525860;522730;1402269;208
ISIC_0008524;100;3;2;100.0;0.6;4288;2848;12212224;5531506;4774;5531506;323767;318993;5536280;100
ISIC_0013082;300;2;2;100.0;0.6;3872;2592;10036224;2201318;224;2201318;254836;254612;2201542;325
ISIC_0007332;300;1;1;0.01;0.6;3024;2016;6096384;5011550;0;5011550;530766;530766;5011550;301
ISIC_0013082;450;3;2;1.0;0.6;3872;2592;10036224;1785327;0;1785327;254836;254836;1785327;518
ISIC_0014428;50;4;2;0.1;0.6;4288;2848;12212224;2816331;8370;2816331;525860;517490;2824701;52
ISIC_0003657;350;2;1;10.0;0.6;3024;2016;6096384;1647061;2927;1647061;340261;337334;1649988;379
ISIC_0008524;250;2;1;1.0;0.6;4288;2848;12212224;4539951;9043;4539951;323767;314724;4548994;258
ISIC_0013082;250;1;3;1.0;0.6;3872;2592;10036224;2105851;0;2105851;254836;254836;2105851;253
ISIC_0014428;200;2;2;10.0;0.6;4288;2848;12212224;1500186;999;1500186;525860;524861;1501185;204
ISIC_0013082;100;2;3;1.0;0.6;3872;2592;10036224;2997961;0;2997961;254836;254836;2997961;88
ISIC_0003657;400;2;2;0.1;0.6;3024;2016;6096384;1619173;0;1619173;340261;340261;1619173;442
ISIC_0003657;300;2;1;0.1;0.6;3024;2016;6096384;1816618;0;1816618;340261;340261;1816618;317
ISIC_0007332;350;2;2;10.0;0.6;3024;2016;6096384;4872093;0;4872093;530766;530766;4872093;384
ISIC_0012547;450;3;3;1.0;0.6;4288;2848;12212224;11226921;108732;11226921;572681;463949;11335653;523
ISIC_0014712;200;3;3;100.0;0.6;6621;4422;29278062;1404141;16368492;1404141;24292916;7924424;17772633;225
ISIC_0014623;100;3;2;0.1;0.6;2592;1936;5018112;1612451;643953;1612451;1937167;1293214;2256404;97
ISIC_0007332;300;4;2;1.0;0.6;3024;2016;6096384;5067816;0;5067816;530766;530766;5067816;353
ISIC_0003657;250;4;2;0.1;0.6;3024;2016;6096384;1786236;689;1786236;340261;339572;1786925;292
ISIC_0003657;250;3;3;0.1;0.6;3024;2016;6096384;1779733;570;1779733;340261;339691;1780303;282
ISIC_0014623;400;2;2;0.01;0.6;2592;1936;5018112;1042818;1050109;1042818;1937167;887058;2092927;441
ISIC_0014428;450;3;1;100.0;0.6;4288;2848;12212224;1128313;8163;1128313;525860;517697;1136476;515
ISIC_0008524;200;4;2;1.0;0.6;4288;2848;12212224;4060367;9815;4060367;323767;313952;4070182;233
ISIC_0008524;150;2;1;10.0;0.6;4288;2848;12212224;4993804;5649;4993804;323767;318118;4999453;139
ISIC_0013082;450;3;1;10.0;0.6;3872;2592;10036224;1722793;1608;1722793;254836;253228;1724401;514
ISIC_0014712;250;3;2;1.0;0.6;6621;4422;29278062;1784876;17065238;1784876;24292916;7227678;18850114;278
ISIC_0007332;250;2;2;10.0;0.6;3024;2016;6096384;5174623;895;5174623;530766;529871;5175518;264
ISIC_0003657;250;2;2;10.0;0.6;3024;2016;6096384;1824792;296;1824792;340261;339965;1825088;264
ISIC_0003657;150;3;3;10.0;0.6;3024;2016;6096384;2093608;1986;2093608;340261;338275;2095594;164
ISIC_0003657;450;4;2;100.0;0.6;3024;2016;6096384;1372964;1807;1372964;340261;338454;1374771;535
ISIC_0014623;200;3;2;1.0;0.6;2592;1936;5018112;1235588;944242;1235588;1937167;992925;2179830;218
ISIC_0014428;400;4;1;10.0;0.6;4288;2848;12212224;1078368;2798;1078368;525860;523062;1081166;469
ISIC_0014428;200;2;1;100.0;0.6;4288;2848;12212224;1500209;999;1500209;525860;524861;1501208;200
ISIC_0014712;350;3;1;1.0;0.6;6621;4422;29278062;1248107;17167149;1248107;24292916;7125767;18415256;393
ISIC_0013188;450;2;2;0.01;0.6;3008;2000;6016000;3228775;0;3228775;92544;92544;3228775;501
ISIC_0007332;450;3;1;100.0;0.6;3024;2016;6096384;4683670;83;4683670;530766;530683;4683753;515
ISIC_0013188;100;1;2;10.0;0.6;3008;2000;6016000;4864409;0;4864409;92544;92544;4864409;69
ISIC_0014623;150;3;2;0.1;0.6;2592;1936;5018112;1354826;907700;1354826;1937167;1029467;2262526;157
ISIC_0012547;250;3;2;0.1;0.6;4288;2848;12212224;11534104;0;11534104;572681;572681;11534104;277
ISIC_0013082;200;2;1;100.0;0.6;3872;2592;10036224;2123932;200;2123932;254836;254636;2124132;200
ISIC_0014623;400;1;1;1.0;0.6;2592;1936;5018112;1174247;967827;1174247;1937167;969340;2142074;423
ISIC_0014712;250;2;2;0.01;0.6;6621;4422;29278062;1815647;16895844;1815647;24292916;7397072;18711491;261
ISIC_0014623;250;1;1;10.0;0.6;2592;1936;5018112;1407332;890824;1407332;1937167;1046343;2298156;244
ISIC_0013082;250;3;3;0.1;0.6;3872;2592;10036224;1917611;9474;1917611;254836;245362;1927085;282
ISIC_0013128;350;2;3;1.0;0.6;3872;2592;10036224;4996640;0;4996640;470897;470897;4996640;388
ISIC_0003657;200;3;1;0.1;0.6;3024;2016;6096384;1889719;0;1889719;340261;340261;1889719;212
ISIC_0014428;250;2;3;1.0;0.6;4288;2848;12212224;1411265;0;1411265;525860;525860;1411265;268
ISIC_0003657;150;1;1;10.0;0.6;3024;2016;6096384;2377437;1986;2377437;340261;338275;2379423;124
ISIC_0014712;100;1;2;0.01;0.6;6621;4422;29278062;3717004;11190713;3717004;24292916;13102203;14907717;66
ISIC_0003657;350;1;2;1.0;0.6;3024;2016;6096384;1805519;2927;1805519;340261;337334;1808446;368
ISIC_0014623;200;3;3;10.0;0.6;2592;1936;5018112;1235388;918926;1235388;1937167;1018241;2154314;224
ISIC_0013188;300;3;3;100.0;0.6;3008;2000;6016000;3696098;45;3696098;92544;92499;3696143;345
ISIC_0008524;200;2;3;10.0;0.6;4288;2848;12212224;4659214;11825;4659214;323767;311942;4671039;209
ISIC_0013188;200;1;1;100.0;0.6;3008;2000;6016000;4007583;0;4007583;92544;92544;4007583;185
ISIC_0014712;200;1;2;100.0;0.6;6621;4422;29278062;1419760;14624016;1419760;24292916;9668900;16043776;190
ISIC_0013188;50;2;3;10.0;0.6;3008;2000;6016000;5062086;0;5062086;92544;92544;5062086;29
ISIC_0003657;250;2;1;1.0;0.6;3024;2016;6096384;1824499;307;1824499;340261;339954;1824806;258
ISIC_0008524;300;2;1;0.01;0.6;4288;2848;12212224;4374851;0;4374851;323767;323767;4374851;316
ISIC_0014428;300;4;3;10.0;0.6;4288;2848;12212224;1211478;1843;1211478;525860;524017;1213321;359
ISIC_0007332;200;1;1;0.1;0.6;3024;2016;6096384;5210084;0;5210084;530766;530766;5210084;182
ISIC_0003657;450;4;1;100.0;0.6;3024;2016;6096384;1372935;1807;1372935;340261;338454;1374742;530
ISIC_0014428;350;4;3;0.1;0.6;4288;2848;12212224;958973;0;958973;525860;525860;958973;417
ISIC_0014428;400;3;2;0.01;0.6;4288;2848;12212224;984053;6156;984053;525860;519704;990209;456
ISIC_0014623;350;4;2;0.1;0.6;2592;1936;5018112;948660;1147141;948660;1937167;790026;2095801;412
ISIC_0008524;100;1;1;0.1;0.6;4288;2848;12212224;5742923;5124;5742923;323767;318643;5748047;62
ISIC_0013128;350;2;3;100.0;0.6;3872;2592;10036224;4996106;0;4996106;470897;470897;4996106;390
ISIC_0013188;400;3;1;100.0;0.6;3008;2000;6016000;3250017;0;3250017;92544;92544;3250017;455
ISIC_0012547;50;2;3;10.0;0.6;4288;2848;12212224;10807629;0;10807629;572681;572681;10807629;29
ISIC_0014428;450;4;1;100.0;0.6;4288;2848;12212224;1128313;8163;1128313;525860;517697;1136476;530
ISIC_0014623;50;3;3;0.01;0.6;2592;1936;5018112;2104134;502729;2104134;1937167;1434438;2606863;41
ISIC_0014623;200;2;1;0.01;0.6;2592;1936;5018112;1384972;823583;1384972;1937167;1113584;2208555;196
ISIC_0012547;150;1;3;1.0;0.6;4288;2848;12212224;11557763;0;11557763;572681;572681;11557763;133
ISIC_0014428;250;2;1;1.0;0.6;4288;2848;12212224;1364695;0;1364695;525860;525860;1364695;258
ISIC_0008524;200;3;1;0.01;0.6;4288;2848;12212224;4855490;0;4855490;323767;323767;4855490;211
ISIC_0007332;200;4;1;0.01;0.6;3024;2016;6096384;5348472;0;5348472;530766;530766;5348472;226
ISIC_0013188;300;3;2;1.0;0.6;3008;2000;6016000;3696133;35;3696133;92544;92509;3696168;338
ISIC_0013128;50;3;1;0.1;0.6;3872;2592;10036224;7290634;0;7290634;470897;470897;7290634;32
ISIC_0008524;400;1;2;0.01;0.6;4288;2848;12212224;4187654;6743;4187654;323767;317024;4194397;426
ISIC_0013128;300;4;2;1.0;0.6;3872;2592;10036224;4966425;55;4966425;470897;470842;4966480;353
ISIC_0014623;300;4;2;100.0;0.6;2592;1936;5018112;1030116;1128003;1030116;1937167;809164;2158119;355
ISIC_0014712;100;3;2;100.0;0.6;6621;4422;29278062;3327018;12430920;3327018;24292916;11861996;15757938;100
ISIC_0013082;200;1;1;1.0;0.6;3872;2592;10036224;2085477;393;2085477;254836;254443;2085870;183
ISIC_0013188;150;1;3;1.0;0.6;3008;2000;6016000;4476407;0;4476407;92544;92544;4476407;133
ISIC_0013082;50;4;1;1.0;0.6;3872;2592;10036224;3805367;0;3805367;254836;254836;3805367;48
ISIC_0013188;300;1;1;10.0;0.6;3008;2000;6016000;3695991;45;3695991;92544;92499;3696036;304
ISIC_0007332;350;1;3;1.0;0.6;3024;2016;6096384;4871975;0;4871975;530766;530766;4871975;373
ISIC_0014712;150;3;2;0.01;0.6;6621;4422;29278062;1885796;14938501;1885796;24292916;9354415;16824297;156
ISIC_0014623;50;3;1;10.0;0.6;2592;1936;5018112;2054518;436566;2054518;1937167;1500601;2491084;34
ISIC_0007332;100;1;2;10.0;0.6;3024;2016;6096384;0;530766;0;530766;0;530766;69
ISIC_0007332;450;3;1;0.1;0.6;3024;2016;6096384;4599461;504;4599461;530766;530262;4599965;512
ISIC_0014623;350;3;2;0.01;0.6;2592;1936;5018112;1065589;1089210;1065589;1937167;847957;2154799;396
ISIC_0008524;150;2;3;1.0;0.6;4288;2848;12212224;5139528;2740;5139528;323767;321027;5142268;148
ISIC_0007332;450;2;2;1.0;0.6;3024;2016;6096384;4683785;83;4683785;530766;530683;4683868;503
ISIC_0014712;200;4;1;100.0;0.6;6621;4422;29278062;1245326;17361316;1245326;24292916;6931600;18606642;230
ISIC_0013128;450;3;3;0.1;0.6;3872;2592;10036224;4634898;0;4634898;470897;470897;4634898;522
ISIC_0014428;150;2;3;100.0;0.6;4288;2848;12212224;2072040;990;2072040;525860;524870;2073030;150
ISIC_0014428;150;2;1;100.0;0.6;4288;2848;12212224;2072040;990;2072040;525860;524870;2073030;140
ISIC_0013188;400;4;2;1.0;0.6;3008;2000;6016000;3234042;0;3234042;92544;92544;3234042;473
ISIC_0013188;350;3;2;10.0;0.6;3008;2000;6016000;3509675;0;3509675;92544;92544;3509675;399
ISIC_0013128;400;4;3;0.1;0.6;3872;2592;10036224;4502942;0;4502942;470897;470897;4502942;477
ISIC_0007332;450;4;3;0.1;0.6;3024;2016;6096384;4619176;0;4619176;530766;530766;4619176;537
ISIC_0008524;300;3;2;10.0;0.6;4288;2848;12212224;4263971;4070;4263971;323767;319697;4268041;339
ISIC_0013082;350;2;3;10.0;0.6;3872;2592;10036224;1955525;0;1955525;254836;254836;1955525;389
ISIC_0012547;50;3;2;0.01;0.6;4288;2848;12212224;0;572681;0;572681;0;572681;36
ISIC_0012547;50;4;3;100.0;0.6;4288;2848;12212224;10811650;0;10811650;572681;572681;10811650;60
ISIC_0014428;350;1;2;0.01;0.6;4288;2848;12212224;1155909;179;1155909;525860;525681;1156088;366
ISIC_0003657;450;3;3;0.1;0.6;3024;2016;6096384;1499520;0;1499520;340261;340261;1499520;522
ISIC_0013188;50;4;2;0.1;0.6;3008;2000;6016000;5405330;0;5405330;92544;92544;5405330;52
ISIC_0014428;350;1;1;100.0;0.6;4288;2848;12212224;1338154;6259;1338154;525860;519601;1344413;365
ISIC_0014623;100;4;1;100.0;0.6;2592;1936;5018112;1534127;767825;1534127;1937167;1169342;2301952;110
ISIC_0013082;350;4;1;1.0;0.6;3872;2592;10036224;1953343;0;1953343;254836;254836;1953343;408
ISIC_0014712;450;4;2;10.0;0.6;6621;4422;29278062;1058239;19009863;1058239;24292916;5283053;20068102;534
ISIC_0013188;250;2;1;0.1;0.6;3008;2000;6016000;3726969;0;3726969;92544;92544;3726969;257
ISIC_0013128;100;4;2;10.0;0.6;3872;2592;10036224;6459031;0;6459031;470897;470897;6459031;114
ISIC_0013082;300;1;2;0.1;0.6;3872;2592;10036224;1973876;3759;1973876;254836;251077;1977635;307
ISIC_0007332;150;2;3;1.0;0.6;3024;2016;6096384;5525218;0;5525218;530766;530766;5525218;148
ISIC_0013128;150;3;2;0.1;0.6;3872;2592;10036224;5729100;0;5729100;470897;470897;5729100;157
ISIC_0014712;150;2;2;10.0;0.6;6621;4422;29278062;1997847;15165184;1997847;24292916;9127732;17163031;144
ISIC_0013128;300;4;2;10.0;0.6;3872;2592;10036224;4966221;39;4966221;470897;470858;4966260;354
ISIC_0008524;450;4;3;100.0;0.6;4288;2848;12212224;2777495;18436;2777495;323767;305331;2795931;540
ISIC_0003657;300;1;3;10.0;0.6;3024;2016;6096384;1919078;2337;1919078;340261;337924;1921415;314
ISIC_0013128;450;4;1;10.0;0.6;3872;2592;10036224;4437873;0;4437873;470897;470897;4437873;529
ISIC_0014428;250;4;3;0.01;0.6;4288;2848;12212224;1120781;17454;1120781;525860;508406;1138235;296
ISIC_0014428;450;3;1;0.01;0.6;4288;2848;12212224;1032153;0;1032153;525860;525860;1032153;511
ISIC_0007332;150;1;2;0.1;0.6;3024;2016;6096384;5482552;0;5482552;530766;530766;5482552;127
ISIC_0013128;100;1;2;10.0;0.6;3872;2592;10036224;6977537;0;6977537;470897;470897;6977537;69
ISIC_0014712;450;2;1;10.0;0.6;6621;4422;29278062;1061987;18096632;1061987;24292916;6196284;19158619;499
ISIC_0003657;200;4;1;0.01;0.6;3024;2016;6096384;2072155;0;2072155;340261;340261;2072155;226
ISIC_0014623;400;1;2;1.0;0.6;2592;1936;5018112;1174122;967837;1174122;1937167;969330;2141959;428
ISIC_0012547;100;1;2;1.0;0.6;4288;2848;12212224;0;572681;0;572681;0;572681;68
ISIC_0013188;450;1;2;0.01;0.6;3008;2000;6016000;3231308;0;3231308;92544;92544;3231308;486
ISIC_0008524;400;2;3;0.1;0.6;4288;2848;12212224;3945192;3539;3945192;323767;320228;3948731;447
ISIC_0003657;150;3;1;100.0;0.6;3024;2016;6096384;2093523;1986;2093523;340261;338275;2095509;155
ISIC_0013188;300;1;1;0.1;0.6;3008;2000;6016000;3635996;0;3635996;92544;92544;3635996;302
ISIC_0003657;300;2;3;0.1;0.6;3024;2016;6096384;1794851;0;1794851;340261;340261;1794851;327
ISIC_0014712;350;3;2;0.1;0.6;6621;4422;29278062;1128517;17441500;1128517;24292916;6851416;18570017;397
ISIC_0014623;300;1;3;0.01;0.6;2592;1936;5018112;1263690;912534;1263690;1937167;1024633;2176224;311
ISIC_0014623;300;1;3;0.1;0.6;2592;1936;5018112;1219960;967692;1219960;1937167;969475;2187652;312
ISIC_0013188;300;2;3;0.1;0.6;3008;2000;6016000;3648138;0;3648138;92544;92544;3648138;327
ISIC_0014623;300;4;1;1.0;0.6;2592;1936;5018112;1030517;1127874;1030517;1937167;809293;2158391;348
ISIC_0013128;350;1;3;100.0;0.6;3872;2592;10036224;5025719;0;5025719;470897;470897;5025719;375
ISIC_0014712;400;1;1;1.0;0.6;6621;4422;29278062;1404233;16478978;1404233;24292916;7813938;17883211;423
ISIC_0014428;50;1;3;0.01;0.6;4288;2848;12212224;3114189;7103;3114189;525860;518757;3121292;11
ISIC_0012547;100;3;1;10.0;0.6;4288;2848;12212224;0;572681;0;572681;0;572681;94
ISIC_0014623;50;1;3;10.0;0.6;2592;1936;5018112;2352607;423024;2352607;1937167;1514143;2775631;14
ISIC_0013082;200;1;2;1.0;0.6;3872;2592;10036224;2129177;394;2129177;254836;254442;2129571;188
ISIC_0008524;400;1;2;1.0;0.6;4288;2848;12212224;4150357;3836;4150357;323767;319931;4154193;428
ISIC_0012547;50;1;1;0.1;0.6;4288;2848;12212224;0;572681;0;572681;0;572681;2
ISIC_0014623;100;2;2;10.0;0.6;2592;1936;5018112;1582354;624498;1582354;1937167;1312669;2206852;84
ISIC_0013128;50;1;2;0.01;0.6;3872;2592;10036224;7906078;0;7906078;470897;470897;7906078;6
ISIC_0013128;50;3;2;100.0;0.6;3872;2592;10036224;6971248;0;6971248;470897;470897;6971248;40
ISIC_0003657;300;3;2;0.01;0.6;3024;2016;6096384;1644667;18792;1644667;340261;321469;1663459;336
ISIC_0014428;150;1;2;100.0;0.6;4288;2848;12212224;2154405;990;2154405;525860;524870;2155395;130
ISIC_0014428;150;1;2;0.01;0.6;4288;2848;12212224;2191485;0;2191485;525860;525860;2191485;126
ISIC_0008524;400;1;1;0.1;0.6;4288;2848;12212224;4131248;350;4131248;323767;323417;4131598;422
ISIC_0012547;250;1;3;100.0;0.6;4288;2848;12212224;11494346;0;11494346;572681;572681;11494346;255
ISIC_0013082;400;4;2;10.0;0.6;3872;2592;10036224;1834347;0;1834347;254836;254836;1834347;474
ISIC_0013082;450;4;3;10.0;0.6;3872;2592;10036224;1722794;1608;1722794;254836;253228;1724402;539
ISIC_0003657;350;1;2;100.0;0.6;3024;2016;6096384;1804598;2927;1804598;340261;337334;1807525;370
ISIC_0003657;400;4;2;0.1;0.6;3024;2016;6096384;1522576;0;1522576;340261;340261;1522576;472
ISIC_0003657;400;4;3;0.01;0.6;3024;2016;6096384;1449899;14216;1449899;340261;326045;1464115;476
ISIC_0007332;100;4;3;100.0;0.6;3024;2016;6096384;0;530766;0;530766;0;530766;120
ISIC_0014712;350;3;3;100.0;0.6;6621;4422;29278062;1248818;17167267;1248818;24292916;7125649;18416085;405
ISIC_0013128;100;4;2;100.0;0.6;3872;2592;10036224;6459031;0;6459031;470897;470897;6459031;115
ISIC_0014712;50;4;1;1.0;0.6;6621;4422;29278062;2260940;13772555;2260940;24292916;10520361;16033495;48
ISIC_0014712;400;1;2;0.01;0.6;6621;4422;29278062;1109710;16626514;1109710;24292916;7666402;17736224;426
ISIC_0013128;100;3;1;0.01;0.6;3872;2592;10036224;6730277;0;6730277;470897;470897;6730277;91
ISIC_0008524;400;1;1;100.0;0.6;4288;2848;12212224;4134850;13085;4134850;323767;310682;4147935;425
ISIC_0014428;300;2;2;10.0;0.6;4288;2848;12212224;1252280;1843;1252280;525860;524017;1254123;324
ISIC_0014712;400;2;1;1.0;0.6;6621;4422;29278062;1315887;17586231;1315887;24292916;6706685;18902118;438
ISIC_0007332;450;4;2;10.0;0.6;3024;2016;6096384;4640900;83;4640900;530766;530683;4640983;534
ISIC_0013128;450;3;3;100.0;0.6;3872;2592;10036224;4620859;0;4620859;470897;470897;4620859;525
ISIC_0013128;50;4;3;1.0;0.6;3872;2592;10036224;6780259;0;6780259;470897;470897;6780259;58
ISIC_0012547;150;2;1;10.0;0.6;4288;2848;12212224;11558318;0;11558318;572681;572681;11558318;139
ISIC_0012547;50;4;2;100.0;0.6;4288;2848;12212224;10811681;0;10811681;572681;572681;10811681;55
ISIC_0007332;250;3;2;10.0;0.6;3024;2016;6096384;5150286;895;5150286;530766;529871;5151181;279
ISIC_0014428;450;1;3;1.0;0.6;4288;2848;12212224;1257318;1272;1257318;525860;524588;1258590;493
ISIC_0013082;400;1;3;100.0;0.6;3872;2592;10036224;1809541;0;1809541;254836;254836;1809541;435
ISIC_0008524;300;1;2;10.0;0.6;4288;2848;12212224;4439541;4070;4439541;323767;319697;4443611;309
ISIC_0014428;400;1;1;100.0;0.6;4288;2848;12212224;1256710;1424;1256710;525860;524436;1258134;425
ISIC_0013188;350;1;3;100.0;0.6;3008;2000;6016000;3527127;0;3527127;92544;92544;3527127;375
ISIC_0007332;400;1;2;0.01;0.6;3024;2016;6096384;4701321;13487;4701321;530766;517279;4714808;426
ISIC_0013188;250;1;1;100.0;0.6;3008;2000;6016000;3844362;0;3844362;92544;92544;3844362;245
ISIC_0007332;350;1;2;100.0;0.6;3024;2016;6096384;4872093;0;4872093;530766;530766;4872093;370
ISIC_0014623;100;2;2;100.0;0.6;2592;1936;5018112;1582354;624498;1582354;1937167;1312669;2206852;85
ISIC_0014712;350;2;2;0.01;0.6;6621;4422;29278062;1141277;17198767;1141277;24292916;7094149;18340044;381
ISIC_0013128;50;3;1;10.0;0.6;3872;2592;10036224;6970985;0;6970985;470897;470897;6970985;34
ISIC_0014712;200;2;1;100.0;0.6;6621;4422;29278062;1408737;16226785;1408737;24292916;8066131;17635522;200
ISIC_0014623;350;2;3;0.1;0.6;2592;1936;5018112;1070832;1035559;1070832;1937167;901608;2106391;387
ISIC_0013128;450;3;1;0.1;0.6;3872;2592;10036224;4633491;0;4633491;470897;470897;4633491;512
ISIC_0014428;300;3;2;1.0;0.6;4288;2848;12212224;1124926;2150;1124926;525860;523710;1127076;338
ISIC_0013128;100;3;2;100.0;0.6;3872;2592;10036224;6560098;0;6560098;470897;470897;6560098;100
ISIC_0013188;50;3;2;0.01;0.6;3008;2000;6016000;5520962;0;5520962;92544;92544;5520962;36
ISIC_0013082;200;3;2;0.1;0.6;3872;2592;10036224;2036532;1616;2036532;254836;253220;2038148;217
ISIC_0014428;450;4;3;1.0;0.6;4288;2848;12212224;1148564;1595;1148564;525860;524265;1150159;538
ISIC_0003657;450;1;2;1.0;0.6;3024;2016;6096384;1707099;741;1707099;340261;339520;1707840;488
ISIC_0008524;450;1;3;100.0;0.6;4288;2848;12212224;4007581;18436;4007581;323767;305331;4026017;495
ISIC_0013128;300;3;3;10.0;0.6;3872;2592;10036224;5070304;39;5070304;470897;470858;5070343;344
ISIC_0008524;350;3;2;100.0;0.6;4288;2848;12212224;4100146;277;4100146;323767;323490;4100423;400
ISIC_0014712;250;1;3;1.0;0.6;6621;4422;29278062;2006495;15386313;2006495;24292916;8906603;17392808;253
ISIC_0013188;400;1;2;0.01;0.6;3008;2000;6016000;3191514;92;3191514;92544;92452;3191606;426
ISIC_0008524;400;3;2;0.01;0.6;4288;2848;12212224;3825020;1366;3825020;323767;322401;3826386;456
ISIC_0014428;100;1;2;100.0;0.6;4288;2848;12212224;2634285;534;2634285;525860;525326;2634819;70
ISIC_0008524;50;2;2;0.01;0.6;4288;2848;12212224;7410919;22591;7410919;323767;301176;7433510;21
ISIC_0013082;250;2;2;0.1;0.6;3872;2592;10036224;1872901;3363;1872901;254836;251473;1876264;262
ISIC_0013188;450;4;2;0.01;0.6;3008;2000;6016000;3195329;0;3195329;92544;92544;3195329;531
ISIC_0003657;200;2;1;0.01;0.6;3024;2016;6096384;2189910;0;2189910;340261;340261;2189910;196
ISIC_0014623;100;3;3;1.0;0.6;2592;1936;5018112;1573833;719540;1573833;1937167;1217627;2293373;103
ISIC_0013188;450;4;2;0.1;0.6;3008;2000;6016000;3093296;0;3093296;92544;92544;3093296;532
ISIC_0013188;150;2;3;10.0;0.6;3008;2000;6016000;4477530;0;4477530;92544;92544;4477530;149
ISIC_0014623;300;3;2;0.1;0.6;2592;1936;5018112;1061330;1097806;1061330;1937167;839361;2159136;337
ISIC_0013082;450;4;3;1.0;0.6;3872;2592;10036224;1785195;0;1785195;254836;254836;1785195;538
ISIC_0014623;350;4;2;100.0;0.6;2592;1936;5018112;960263;1144171;960263;1937167;792996;2104434;415
ISIC_0013188;200;3;2;100.0;0.6;3008;2000;6016000;4007524;0;4007524;92544;92544;4007524;220
ISIC_0008524;350;2;1;0.1;0.6;4288;2848;12212224;4018683;199;4018683;323767;323568;4018882;377
ISIC_0008524;50;1;1;0.01;0.6;4288;2848;12212224;7659177;0;7659177;323767;323767;7659177;1
ISIC_0012547;350;2;3;100.0;0.6;4288;2848;12212224;11254078;36400;11254078;572681;536281;11290478;390
ISIC_0012547;400;3;3;1.0;0.6;4288;2848;12212224;11191954;61250;11191954;572681;511431;11253204;463
ISIC_0014623;450;3;2;1.0;0.6;2592;1936;5018112;954548;1178422;954548;1937167;758745;2132970;518
ISIC_0007332;400;4;2;1.0;0.6;3024;2016;6096384;4767063;0;4767063;530766;530766;4767063;473
ISIC_0014712;350;2;3;100.0;0.6;6621;4422;29278062;1252948;17087599;1252948;24292916;7205317;18340547;390
ISIC_0013188;250;1;1;0.1;0.6;3008;2000;6016000;3750422;0;3750422;92544;92544;3750422;242
ISIC_0014712;200;3;3;10.0;0.6;6621;4422;29278062;1404141;16368488;1404141;24292916;7924428;17772629;224
ISIC_0013188;300;3;1;0.1;0.6;3008;2000;6016000;3585431;0;3585431;92544;92544;3585431;332
ISIC_0008524;150;3;2;0.01;0.6;4288;2848;12212224;5272464;0;5272464;323767;323767;5272464;156
ISIC_0003657;100;2;1;0.01;0.6;3024;2016;6096384;2889494;0;2889494;340261;340261;2889494;76
ISIC_0014428;350;4;3;1.0;0.6;4288;2848;12212224;1163519;8938;1163519;525860;516922;1172457;418
ISIC_0014428;400;4;2;0.1;0.6;4288;2848;12212224;871435;11339;871435;525860;514521;882774;472
ISIC_0012547;150;4;3;10.0;0.6;4288;2848;12212224;11558318;0;11558318;572681;572681;11558318;179
ISIC_0013128;50;1;3;0.01;0.6;3872;2592;10036224;7889137;0;7889137;470897;470897;7889137;11
ISIC_0012547;50;2;3;100.0;0.6;4288;2848;12212224;10811912;0;10811912;572681;572681;10811912;30
ISIC_0014712;300;1;3;10.0;0.6;6621;4422;29278062;1326291;15822374;1326291;24292916;8470542;17148665;314
ISIC_0003657;50;2;1;10.0;0.6;3024;2016;6096384;2534581;72;2534581;340261;340189;2534653;19
ISIC_0013188;250;2;2;0.01;0.6;3008;2000;6016000;3955747;0;3955747;92544;92544;3955747;261
ISIC_0014428;150;3;2;1.0;0.6;4288;2848;12212224;1905322;2488;1905322;525860;523372;1907810;158
ISIC_0013128;150;3;2;1.0;0.6;3872;2592;10036224;5745612;0;5745612;470897;470897;5745612;158
ISIC_0007332;350;1;1;0.1;0.6;3024;2016;6096384;4765922;73;4765922;530766;530693;4765995;362
ISIC_0013128;350;4;1;0.01;0.6;3872;2592;10036224;4888844;0;4888844;470897;470897;4888844;406
ISIC_0014428;450;1;3;0.1;0.6;4288;2848;12212224;895519;0;895519;525860;525860;895519;492
ISIC_0012547;450;3;2;1.0;0.6;4288;2848;12212224;11226750;108833;11226750;572681;463848;11335583;518
ISIC_0014712;450;2;3;1.0;0.6;6621;4422;29278062;1061947;18096379;1061947;24292916;6196537;19158326;508
ISIC_0014428;250;1;3;10.0;0.6;4288;2848;12212224;1469675;4628;1469675;525860;521232;1474303;254
ISIC_0013128;150;1;2;100.0;0.6;3872;2592;10036224;5946074;0;5946074;470897;470897;5946074;130
ISIC_0012547;50;1;3;100.0;0.6;4288;2848;12212224;10812148;0;10812148;572681;572681;10812148;15
ISIC_0014623;250;4;3;0.1;0.6;2592;1936;5018112;1083468;1084451;1083468;1937167;852716;2167919;297
ISIC_0013082;50;1;2;0.01;0.6;3872;2592;10036224;3420756;7863;3420756;254836;246973;3428619;6
ISIC_0013082;100;2;1;100.0;0.6;3872;2592;10036224;2998289;0;2998289;254836;254836;2998289;80
ISIC_0013082;450;2;2;100.0;0.6;3872;2592;10036224;1722804;1608;1722804;254836;253228;1724412;505
ISIC_0013082;200;1;3;1.0;0.6;3872;2592;10036224;2129562;396;2129562;254836;254440;2129958;193
ISIC_0013188;350;4;1;1.0;0.6;3008;2000;6016000;3508088;0;3508088;92544;92544;3508088;408
ISIC_0007332;50;2;3;0.01;0.6;3024;2016;6096384;0;530766;0;530766;0;530766;26
ISIC_0014623;450;1;1;1.0;0.6;2592;1936;5018112;1098756;1022314;1098756;1937167;914853;2121070;483
ISIC_0013082;200;2;3;100.0;0.6;3872;2592;10036224;2123938;200;2123938;254836;254636;2124138;210
ISIC_0014712;200;3;2;0.01;0.6;6621;4422;29278062;1651470;16042909;1651470;24292916;8250007;17694379;216
ISIC_0014712;50;3;3;10.0;0.6;6621;4422;29278062;2849626;13299681;2849626;24292916;10993235;16149307;44
ISIC_0013188;300;3;3;10.0;0.6;3008;2000;6016000;3696167;45;3696167;92544;92499;3696212;344
ISIC_0014623;450;1;3;0.01;0.6;2592;1936;5018112;1105589;1025016;1105589;1937167;912151;2130605;491
ISIC_0008524;50;2;2;100.0;0.6;4288;2848;12212224;6157221;12029;6157221;323767;311738;6169250;25
ISIC_0007332;250;2;3;0.1;0.6;3024;2016;6096384;5125882;377;5125882;530766;530389;5126259;267
ISIC_0012547;300;3;2;1.0;0.6;4288;2848;12212224;11302712;81608;11302712;572681;491073;11384320;338
ISIC_0014712;250;1;1;1.0;0.6;6621;4422;29278062;2006286;15386556;2006286;24292916;8906360;17392842;243
ISIC_0013128;450;3;1;0.01;0.6;3872;2592;10036224;4752524;0;4752524;470897;470897;4752524;511
ISIC_0014623;50;3;1;0.1;0.6;2592;1936;5018112;2048492;444268;2048492;1937167;1492899;2492760;32
ISIC_0014623;100;3;2;0.01;0.6;2592;1936;5018112;1664060;746780;1664060;1937167;1190387;2410840;96
ISIC_0007332;250;1;3;0.1;0.6;3024;2016;6096384;5126160;255;5126160;530766;530511;5126415;252
ISIC_0013128;300;3;2;10.0;0.6;3872;2592;10036224;5070752;39;5070752;470897;470858;5070791;339
ISIC_0013128;250;2;3;0.01;0.6;3872;2592;10036224;5547885;0;5547885;470897;470897;5547885;266
ISIC_0003657;250;1;2;100.0;0.6;3024;2016;6096384;2034390;296;2034390;340261;339965;2034686;250
ISIC_0007332;150;2;1;0.1;0.6;3024;2016;6096384;5522187;0;5522187;530766;530766;5522187;137
ISIC_0013128;200;3;2;100.0;0.6;3872;2592;10036224;5615094;0;5615094;470897;470897;5615094;220
ISIC_0003657;150;2;2;1.0;0.6;3024;2016;6096384;2212825;2152;2212825;340261;338109;2214977;143
ISIC_0014428;100;1;2;0.01;0.6;4288;2848;12212224;2673346;0;2673346;525860;525860;2673346;66
ISIC_0003657;400;1;2;1.0;0.6;3024;2016;6096384;1795951;3990;1795951;340261;336271;1799941;428
ISIC_0007332;200;3;2;100.0;0.6;3024;2016;6096384;5168793;0;5168793;530766;530766;5168793;220
ISIC_0003657;300;2;1;10.0;0.6;3024;2016;6096384;1706460;2337;1706460;340261;337924;1708797;319
ISIC_0003657;250;1;3;0.01;0.6;3024;2016;6096384;2199167;1544;2199167;340261;338717;2200711;251
ISIC_0014623;400;3;3;10.0;0.6;2592;1936;5018112;1008929;1100402;1008929;1937167;836765;2109331;464
ISIC_0013128;150;4;2;1.0;0.6;3872;2592;10036224;5678563;0;5678563;470897;470897;5678563;173
ISIC_0008524;100;4;2;0.01;0.6;4288;2848;12212224;5809854;2616;5809854;323767;321151;5812470;111
ISIC_0013188;450;4;3;0.01;0.6;3008;2000;6016000;3113383;1655;3113383;92544;90889;3115038;536
ISIC_0012547;200;2;1;0.1;0.6;4288;2848;12212224;11513441;0;11513441;572681;572681;11513441;197
ISIC_0003657;150;3;3;0.01;0.6;3024;2016;6096384;2029756;16404;2029756;340261;323857;2046160;161
ISIC_0012547;150;3;2;1.0;0.6;4288;2848;12212224;11558084;0;11558084;572681;572681;11558084;158
ISIC_0014428;400;4;3;0.01;0.6;4288;2848;12212224;844069;15579;844069;525860;510281;859648;476
ISIC_0014623;450;3;3;100.0;0.6;2592;1936;5018112;954427;1178551;954427;1937167;758616;2132978;525
ISIC_0014428;300;1;1;100.0;0.6;4288;2848;12212224;1337724;1843;1337724;525860;524017;1339567;305
ISIC_0012547;400;2;2;0.1;0.6;4288;2848;12212224;11233496;0;11233496;572681;572681;11233496;442
ISIC_0014712;50;3;3;1.0;0.6;6621;4422;29278062;2466009;12862378;2466009;24292916;11430538;15328387;43
ISIC_0008524;450;2;1;10.0;0.6;4288;2848;12212224;3870647;18436;3870647;323767;305331;3889083;499
ISIC_0013082;400;3;3;0.1;0.6;3872;2592;10036224;1681382;0;1681382;254836;254836;1681382;462
ISIC_0013128;100;2;3;0.1;0.6;3872;2592;10036224;6774498;0;6774498;470897;470897;6774498;87
ISIC_0008524;50;3;1;10.0;0.6;4288;2848;12212224;6380589;11966;6380589;323767;311801;6392555;34
ISIC_0013128;300;1;2;10.0;0.6;3872;2592;10036224;5178431;39;5178431;470897;470858;5178470;309
ISIC_0013128;250;1;1;0.01;0.6;3872;2592;10036224;5458549;0;5458549;470897;470897;5458549;241
ISIC_0013082;250;3;1;0.1;0.6;3872;2592;10036224;1962257;24;1962257;254836;254812;1962281;272
ISIC_0012547;350;1;1;0.1;0.6;4288;2848;12212224;11261187;0;11261187;572681;572681;11261187;362
ISIC_0007332;450;1;2;0.1;0.6;3024;2016;6096384;4575162;0;4575162;530766;530766;4575162;487
ISIC_0003657;100;3;2;1.0;0.6;3024;2016;6096384;2440746;345;2440746;340261;339916;2441091;98
ISIC_0013128;150;2;2;0.1;0.6;3872;2592;10036224;5865243;0;5865243;470897;470897;5865243;142
ISIC_0003657;150;4;2;100.0;0.6;3024;2016;6096384;1972508;1986;1972508;340261;338275;1974494;175
ISIC_0008524;50;3;1;100.0;0.6;4288;2848;12212224;6380691;11966;6380691;323767;311801;6392657;35
ISIC_0014623;100;3;1;10.0;0.6;2592;1936;5018112;1573660;719346;1573660;1937167;1217821;2293006;94
ISIC_0013128;300;3;3;100.0;0.6;3872;2592;10036224;5070304;39;5070304;470897;470858;5070343;345
ISIC_0008524;150;4;3;1.0;0.6;4288;2848;12212224;4319991;2050;4319991;323767;321717;4322041;178
ISIC_0007332;150;4;3;10.0;0.6;3024;2016;6096384;5525218;0;5525218;530766;530766;5525218;179
ISIC_0003657;250;4;1;1.0;0.6;3024;2016;6096384;1668993;307;1668993;340261;339954;1669300;288
ISIC_0007332;300;1;3;0.1;0.6;3024;2016;6096384;5042292;0;5042292;530766;530766;5042292;312
ISIC_0013128;350;3;2;0.1;0.6;3872;2592;10036224;4914694;0;4914694;470897;470897;4914694;397
ISIC_0014623;150;1;3;100.0;0.6;2592;1936;5018112;1658863;679444;1658863;1937167;1257723;2338307;135
ISIC_0003657;150;2;3;100.0;0.6;3024;2016;6096384;2215834;1986;2215834;340261;338275;2217820;150
ISIC_0007332;50;4;2;1.0;0.6;3024;2016;6096384;5116920;0;5116920;530766;530766;5116920;53
ISIC_0012547;100;3;2;0.1;0.6;4288;2848;12212224;0;572681;0;572681;0;572681;97
ISIC_0013082;200;4;3;100.0;0.6;3872;2592;10036224;2123938;200;2123938;254836;254636;2124138;240
ISIC_0013188;250;4;3;0.01;0.6;3008;2000;6016000;3916336;368;3916336;92544;92176;3916704;296
ISIC_0013128;300;1;3;10.0;0.6;3872;2592;10036224;5178619;39;5178619;470897;470858;5178658;314
ISIC_0013082;400;2;1;100.0;0.6;3872;2592;10036224;1809540;0;1809540;254836;254836;1809540;440
ISIC_0013128;100;4;1;0.01;0.6;3872;2592;10036224;6620916;0;6620916;470897;470897;6620916;106
ISIC_0014712;200;4;2;100.0;0.6;6621;4422;29278062;1245326;17361314;1245326;24292916;6931602;18606640;235
ISIC_0013128;300;1;3;0.1;0.6;3872;2592;10036224;5106451;0;5106451;470897;470897;5106451;312
ISIC_0013128;450;1;2;0.01;0.6;3872;2592;10036224;4910967;0;4910967;470897;470897;4910967;486
ISIC_0013128;150;4;1;0.1;0.6;3872;2592;10036224;5661201;0;5661201;470897;470897;5661201;167
ISIC_0012547;150;1;2;100.0;0.6;4288;2848;12212224;11558318;0;11558318;572681;572681;11558318;130
ISIC_0008524;100;1;2;0.1;0.6;4288;2848;12212224;5621688;3735;5621688;323767;320032;5625423;67
ISIC_0014623;250;1;3;10.0;0.6;2592;1936;5018112;1407478;890682;1407478;1937167;1046485;2298160;254
ISIC_0013188;50;1;1;100.0;0.6;3008;2000;6016000;5061939;0;5061939;92544;92544;5061939;5
ISIC_0008524;250;1;3;100.0;0.6;4288;2848;12212224;4539467;7441;4539467;323767;316326;4546908;255
ISIC_0012547;100;4;1;0.01;0.6;4288;2848;12212224;0;572681;0;572681;0;572681;106
ISIC_0003657;200;2;3;100.0;0.6;3024;2016;6096384;1934538;304;1934538;340261;339957;1934842;210
ISIC_0013188;250;4;1;1.0;0.6;3008;2000;6016000;3797248;0;3797248;92544;92544;3797248;288
ISIC_0007332;150;2;1;1.0;0.6;3024;2016;6096384;5525218;0;5525218;530766;530766;5525218;138
ISIC_0007332;100;1;1;0.1;0.6;3024;2016;6096384;0;530766;0;530766;0;530766;62
ISIC_0013082;200;4;3;10.0;0.6;3872;2592;10036224;2123919;200;2123919;254836;254636;2124119;239
ISIC_0012547;200;3;1;0.1;0.6;4288;2848;12212224;11513507;0;11513507;572681;572681;11513507;212
ISIC_0012547;350;4;2;1.0;0.6;4288;2848;12212224;11254391;106338;11254391;572681;466343;11360729;413
ISIC_0013128;100;3;2;0.01;0.6;3872;2592;10036224;6732467;0;6732467;470897;470897;6732467;96
ISIC_0008524;150;3;3;10.0;0.6;4288;2848;12212224;4911439;5649;4911439;323767;318118;4917088;164
ISIC_0013128;50;3;3;100.0;0.6;3872;2592;10036224;6971273;0;6971273;470897;470897;6971273;45
ISIC_0013082;450;1;3;1.0;0.6;3872;2592;10036224;1742633;2886;1742633;254836;251950;1745519;493
ISIC_0008524;50;3;1;0.1;0.6;4288;2848;12212224;7152288;0;7152288;323767;323767;7152288;32
ISIC_0013082;100;1;3;1.0;0.6;3872;2592;10036224;3104576;0;3104576;254836;254836;3104576;73
ISIC_0014623;200;3;1;0.1;0.6;2592;1936;5018112;1214781;926609;1214781;1937167;1010558;2141390;212
ISIC_0008524;100;1;1;10.0;0.6;4288;2848;12212224;5653236;4776;5653236;323767;318991;5658012;64
ISIC_0013128;50;2;3;0.01;0.6;3872;2592;10036224;7896140;0;7896140;470897;470897;7896140;26
ISIC_0013128;100;1;2;0.1;0.6;3872;2592;10036224;6875015;0;6875015;470897;470897;6875015;67
ISIC_0013188;50;3;2;10.0;0.6;3008;2000;6016000;5062081;0;5062081;92544;92544;5062081;39
ISIC_0007332;250;4;2;100.0;0.6;3024;2016;6096384;5150286;895;5150286;530766;529871;5151181;295
ISIC_0013082;100;1;1;10.0;0.6;3872;2592;10036224;3104061;0;3104061;254836;254836;3104061;64
ISIC_0014712;50;2;1;10.0;0.6;6621;4422;29278062;2464669;12862508;2464669;24292916;11430408;15327177;19
ISIC_0013188;50;1;2;0.01;0.6;3008;2000;6016000;5524541;0;5524541;92544;92544;5524541;6
ISIC_0013082;350;3;3;1.0;0.6;3872;2592;10036224;1953708;0;1953708;254836;254836;1953708;403
ISIC_0013128;350;1;3;0.01;0.6;3872;2592;10036224;5044315;0;5044315;470897;470897;5044315;371
ISIC_0013128;100;4;1;10.0;0.6;3872;2592;10036224;6459066;0;6459066;470897;470897;6459066;109
ISIC_0008524;200;3;1;100.0;0.6;4288;2848;12212224;4547387;11825;4547387;323767;311942;4559212;215
ISIC_0013082;400;1;3;0.1;0.6;3872;2592;10036224;1630361;0;1630361;254836;254836;1630361;432
ISIC_0013188;300;1;3;0.01;0.6;3008;2000;6016000;3657553;0;3657553;92544;92544;3657553;311
ISIC_0008524;200;1;2;0.01;0.6;4288;2848;12212224;4971016;0;4971016;323767;323767;4971016;186
ISIC_0007332;150;2;3;100.0;0.6;3024;2016;6096384;5525218;0;5525218;530766;530766;5525218;150
ISIC_0013082;450;1;3;10.0;0.6;3872;2592;10036224;1722793;1608;1722793;254836;253228;1724401;494
ISIC_0008524;100;3;1;1.0;0.6;4288;2848;12212224;5637472;1780;5637472;323767;321987;5639252;93
ISIC_0014712;100;3;2;0.01;0.6;6621;4422;29278062;3075768;14066239;3075768;24292916;10226677;17142007;96
ISIC_0013188;150;2;1;100.0;0.6;3008;2000;6016000;4477347;0;4477347;92544;92544;4477347;140
ISIC_0008524;300;4;2;1.0;0.6;4288;2848;12212224;3703991;982;3703991;323767;322785;3704973;353
ISIC_0013188;250;2;3;1.0;0.6;3008;2000;6016000;3846352;0;3846352;92544;92544;3846352;268
ISIC_0008524;100;2;1;0.01;0.6;4288;2848;12212224;6169830;1889;6169830;323767;321878;6171719;76
ISIC_0003657;400;1;1;100.0;0.6;3024;2016;6096384;1781225;3890;1781225;340261;336371;1785115;425
ISIC_0003657;450;4;2;10.0;0.6;3024;2016;6096384;1372861;1807;1372861;340261;338454;1374668;534
ISIC_0007332;350;3;3;100.0;0.6;3024;2016;6096384;4871964;0;4871964;530766;530766;4871964;405
ISIC_0014428;100;2;1;0.1;0.6;4288;2848;12212224;2309539;0;2309539;525860;525860;2309539;77
ISIC_0014428;350;2;1;0.1;0.6;4288;2848;12212224;1014370;0;1014370;525860;525860;1014370;377
ISIC_0012547;400;3;3;10.0;0.6;4288;2848;12212224;11191891;61250;11191891;572681;511431;11253141;464
ISIC_0007332;250;3;1;10.0;0.6;3024;2016;6096384;5150273;895;5150273;530766;529871;5151168;274
ISIC_0013128;150;2;2;10.0;0.6;3872;2592;10036224;5812694;0;5812694;470897;470897;5812694;144
ISIC_0003657;200;1;2;0.01;0.6;3024;2016;6096384;2278607;14004;2278607;340261;326257;2292611;186
ISIC_0007332;350;1;2;0.1;0.6;3024;2016;6096384;4792396;63;4792396;530766;530703;4792459;367
ISIC_0014623;250;1;3;1.0;0.6;2592;1936;5018112;1388572;890777;1388572;1937167;1046390;2279349;253
ISIC_0013082;300;3;2;100.0;0.6;3872;2592;10036224;2200847;224;2200847;254836;254612;2201071;340
ISIC_0013128;200;2;3;0.01;0.6;3872;2592;10036224;5800769;0;5800769;470897;470897;5800769;206
ISIC_0012547;250;2;2;0.1;0.6;4288;2848;12212224;11535503;0;11535503;572681;572681;11535503;262
ISIC_0014623;200;4;1;10.0;0.6;2592;1936;5018112;1160503;976779;1160503;1937167;960388;2137282;229
ISIC_0013082;300;1;3;1.0;0.6;3872;2592;10036224;2130346;1082;2130346;254836;253754;2131428;313
ISIC_0014428;450;3;2;1.0;0.6;4288;2848;12212224;1148297;1490;1148297;525860;524370;1149787;518
ISIC_0007332;300;4;3;0.01;0.6;3024;2016;6096384;4898650;0;4898650;530766;530766;4898650;356
ISIC_0012547;100;2;3;0.1;0.6;4288;2848;12212224;0;572681;0;572681;0;572681;87
ISIC_0014712;50;4;2;10.0;0.6;6621;4422;29278062;2259574;13772367;2259574;24292916;10520549;16031941;54
ISIC_0014623;150;1;3;0.01;0.6;2592;1936;5018112;1683962;708735;1683962;1937167;1228432;2392697;131
ISIC_0012547;350;2;3;0.01;0.6;4288;2848;12212224;11407893;0;11407893;572681;572681;11407893;386
ISIC_0003657;450;4;1;1.0;0.6;3024;2016;6096384;1372782;1871;1372782;340261;338390;1374653;528
ISIC_0013082;400;2;1;1.0;0.6;3872;2592;10036224;1788420;0;1788420;254836;254836;1788420;438
ISIC_0013082;100;2;2;0.1;0.6;3872;2592;10036224;2871979;15592;2871979;254836;239244;2887571;82
ISIC_0014712;300;1;2;10.0;0.6;6621;4422;29278062;1326291;15822067;1326291;24292916;8470849;17148358;309
ISIC_0013188;200;1;3;10.0;0.6;3008;2000;6016000;4007608;0;4007608;92544;92544;4007608;194
ISIC_0007332;250;2;3;0.01;0.6;3024;2016;6096384;5148215;4959;5148215;530766;525807;5153174;266
ISIC_0013082;350;1;1;0.1;0.6;3872;2592;10036224;1631834;0;1631834;254836;254836;1631834;362
ISIC_0012547;400;2;2;10.0;0.6;4288;2848;12212224;11219541;0;11219541;572681;572681;11219541;444
ISIC_0013128;100;2;2;0.1;0.6;3872;2592;10036224;6774560;0;6774560;470897;470897;6774560;82
ISIC_0007332;50;1;3;0.01;0.6;3024;2016;6096384;0;530766;0;530766;0;530766;11
ISIC_0008524;250;3;2;10.0;0.6;4288;2848;12212224;4328308;7441;4328308;323767;316326;4335749;279
ISIC_0008524;150;2;1;0.1;0.6;4288;2848;12212224;5271796;0;5271796;323767;323767;5271796;137
ISIC_0014712;50;2;3;100.0;0.6;6621;4422;29278062;2849626;13299678;2849626;24292916;10993238;16149304;30
ISIC_0012547;100;1;3;0.01;0.6;4288;2848;12212224;0;572681;0;572681;0;572681;71
ISIC_0007332;300;2;3;0.01;0.6;3024;2016;6096384;4998632;0;4998632;530766;530766;4998632;326
ISIC_0013082;450;4;2;1.0;0.6;3872;2592;10036224;1785112;0;1785112;254836;254836;1785112;533
ISIC_0007332;200;2;1;1.0;0.6;3024;2016;6096384;5165913;0;5165913;530766;530766;5165913;198
ISIC_0013082;450;2;2;10.0;0.6;3872;2592;10036224;1722793;1608;1722793;254836;253228;1724401;504
ISIC_0003657;450;2;1;10.0;0.6;3024;2016;6096384;1551053;1807;1551053;340261;338454;1552860;499
ISIC_0013188;300;1;3;100.0;0.6;3008;2000;6016000;3696024;45;3696024;92544;92499;3696069;315
ISIC_0012547;100;4;2;0.1;0.6;4288;2848;12212224;0;572681;0;572681;0;572681;112
ISIC_0012547;350;4;1;100.0;0.6;4288;2848;12212224;11254071;106338;11254071;572681;466343;11360409;410
ISIC_0014623;300;3;2;100.0;0.6;2592;1936;5018112;1080944;1094721;1080944;1937167;842446;2175665;340
ISIC_0007332;200;4;2;0.1;0.6;3024;2016;6096384;5189385;0;5189385;530766;530766;5189385;232
ISIC_0013082;300;1;2;1.0;0.6;3872;2592;10036224;2130345;1184;2130345;254836;253652;2131529;308
ISIC_0013128;50;3;3;0.01;0.6;3872;2592;10036224;7696661;0;7696661;470897;470897;7696661;41
ISIC_0003657;50;3;3;0.01;0.6;3024;2016;6096384;2796614;11121;2796614;340261;329140;2807735;41
ISIC_0014712;200;3;1;10.0;0.6;6621;4422;29278062;1404141;16368491;1404141;24292916;7924425;17772632;214
ISIC_0013128;250;1;3;0.1;0.6;3872;2592;10036224;5436520;0;5436520;470897;470897;5436520;252
ISIC_0014712;400;2;3;100.0;0.6;6621;4422;29278062;1315892;17585942;1315892;24292916;6706974;18901834;450
ISIC_0008524;150;3;3;0.01;0.6;4288;2848;12212224;5279812;0;5279812;323767;323767;5279812;161
ISIC_0008524;150;1;2;0.01;0.6;4288;2848;12212224;5495372;0;5495372;323767;323767;5495372;126
ISIC_0014712;50;2;3;1.0;0.6;6621;4422;29278062;2466009;12862381;2466009;24292916;11430535;15328390;28
ISIC_0013188;100;2;3;0.1;0.6;3008;2000;6016000;4860778;0;4860778;92544;92544;4860778;87
ISIC_0014712;400;4;1;0.01;0.6;6621;4422;29278062;1212799;18318738;1212799;24292916;5974178;19531537;466
ISIC_0003657;100;2;1;10.0;0.6;3024;2016;6096384;2565218;30;2565218;340261;340231;2565248;79
ISIC_0003657;400;2;3;100.0;0.6;3024;2016;6096384;1610154;3890;1610154;340261;336371;1614044;450
ISIC_0003657;200;2;1;0.1;0.6;3024;2016;6096384;2004579;0;2004579;340261;340261;2004579;197
ISIC_0013082;250;4;1;0.01;0.6;3872;2592;10036224;2216693;0;2216693;254836;254836;2216693;286
ISIC_0007332;250;2;3;100.0;0.6;3024;2016;6096384;5174609;895;5174609;530766;529871;5175504;270
ISIC_0013082;150;3;2;100.0;0.6;3872;2592;10036224;2759697;183;2759697;254836;254653;2759880;160
ISIC_0013188;50;2;1;0.1;0.6;3008;2000;6016000;5404493;0;5404493;92544;92544;5404493;17
ISIC_0013082;300;2;3;100.0;0.6;3872;2592;10036224;2201353;224;2201353;254836;254612;2201577;330
ISIC_0007332;300;3;2;0.1;0.6;3024;2016;6096384;5019608;0;5019608;530766;530766;5019608;337
ISIC_0003657;150;1;3;0.01;0.6;3024;2016;6096384;2360844;15329;2360844;340261;324932;2376173;131
ISIC_0013082;150;2;2;0.1;0.6;3872;2592;10036224;2697835;0;2697835;254836;254836;2697835;142
ISIC_0014712;200;2;3;0.1;0.6;6621;4422;29278062;1499813;16763922;1499813;24292916;7528994;18263735;207
ISIC_0008524;250;3;1;1.0;0.6;4288;2848;12212224;4329187;9332;4329187;323767;314435;4338519;273
ISIC_0003657;300;4;2;0.1;0.6;3024;2016;6096384;1572274;832;1572274;340261;339429;1573106;352
ISIC_0008524;300;1;3;0.1;0.6;4288;2848;12212224;4397307;11126;4397307;323767;312641;4408433;312
ISIC_0013128;450;1;2;1.0;0.6;3872;2592;10036224;4786578;0;4786578;470897;470897;4786578;488
ISIC_0014428;50;2;2;1.0;0.6;4288;2848;12212224;3159617;1679;3159617;525860;524181;3161296;23
ISIC_0012547;450;4;1;10.0;0.6;4288;2848;12212224;11029056;108900;11029056;572681;463781;11137956;529
ISIC_0014712;150;4;1;100.0;0.6;6621;4422;29278062;1799378;16333380;1799378;24292916;7959536;18132758;170
ISIC_0008524;100;4;3;10.0;0.6;4288;2848;12212224;5000578;4773;5000578;323767;318994;5005351;119
ISIC_0003657;100;4;1;10.0;0.6;3024;2016;6096384;2310272;30;2310272;340261;340231;2310302;109
ISIC_0013128;250;2;1;100.0;0.6;3872;2592;10036224;5441595;0;5441595;470897;470897;5441595;260
ISIC_0003657;100;1;3;1.0;0.6;3024;2016;6096384;2754762;932;2754762;340261;339329;2755694;73
ISIC_0014428;400;1;3;0.01;0.6;4288;2848;12212224;921482;16913;921482;525860;508947;938395;431
ISIC_0012547;350;2;3;1.0;0.6;4288;2848;12212224;11254260;36517;11254260;572681;536164;11290777;388
ISIC_0008524;200;4;2;10.0;0.6;4288;2848;12212224;3962471;11825;3962471;323767;311942;3974296;234
ISIC_0014623;300;1;2;0.01;0.6;2592;1936;5018112;1280499;876257;1280499;1937167;1060910;2156756;306
ISIC_0007332;450;1;1;100.0;0.6;3024;2016;6096384;4697242;83;4697242;530766;530683;4697325;485
ISIC_0014712;200;1;2;1.0;0.6;6621;4422;29278062;1529684;14862213;1529684;24292916;9430703;16391897;188
ISIC_0014623;250;3;3;1.0;0.6;2592;1936;5018112;1188058;1026552;1188058;1937167;910615;2214610;283
ISIC_0014428;400;4;1;1.0;0.6;4288;2848;12212224;984095;4782;984095;525860;521078;988877;468
ISIC_0014623;300;2;1;10.0;0.6;2592;1936;5018112;1113840;1061439;1113840;1937167;875728;2175279;319
ISIC_0014428;300;1;3;0.01;0.6;4288;2848;12212224;1284252;2500;1284252;525860;523360;1286752;311
ISIC_0013188;200;4;1;100.0;0.6;3008;2000;6016000;3977654;0;3977654;92544;92544;3977654;230
ISIC_0014623;350;2;1;100.0;0.6;2592;1936;5018112;1096027;1040047;1096027;1937167;897120;2136074;380
ISIC_0003657;400;4;1;1.0;0.6;3024;2016;6096384;1482143;4150;1482143;340261;336111;1486293;468
ISIC_0013082;350;1;3;1.0;0.6;3872;2592;10036224;1953712;0;1953712;254836;254836;1953712;373
ISIC_0013188;400;1;3;100.0;0.6;3008;2000;6016000;3265147;0;3265147;92544;92544;3265147;435
ISIC_0013188;250;4;2;0.1;0.6;3008;2000;6016000;3723075;0;3723075;92544;92544;3723075;292
ISIC_0013128;300;2;2;0.01;0.6;3872;2592;10036224;5025398;0;5025398;470897;470897;5025398;321
ISIC_0008524;400;1;2;10.0;0.6;4288;2848;12212224;4134664;13085;4134664;323767;310682;4147749;429
ISIC_0012547;100;3;2;1.0;0.6;4288;2848;12212224;0;572681;0;572681;0;572681;98
ISIC_0007332;100;3;2;0.01;0.6;3024;2016;6096384;0;530766;0;530766;0;530766;96
ISIC_0013128;50;3;3;1.0;0.6;3872;2592;10036224;6972516;0;6972516;470897;470897;6972516;43
ISIC_0003657;50;3;1;10.0;0.6;3024;2016;6096384;2191898;72;2191898;340261;340189;2191970;34
ISIC_0013188;300;2;1;0.01;0.6;3008;2000;6016000;3857242;0;3857242;92544;92544;3857242;316
ISIC_0013128;200;1;2;10.0;0.6;3872;2592;10036224;5755525;0;5755525;470897;470897;5755525;189
ISIC_0013082;50;2;3;1.0;0.6;3872;2592;10036224;3805887;0;3805887;254836;254836;3805887;28
ISIC_0013082;450;3;1;1.0;0.6;3872;2592;10036224;1743122;3542;1743122;254836;251294;1746664;513
ISIC_0013082;50;2;2;0.1;0.6;3872;2592;10036224;3446487;2359;3446487;254836;252477;3448846;22
ISIC_0014623;450;1;3;0.1;0.6;2592;1936;5018112;1108835;1035560;1108835;1937167;901607;2144395;492
ISIC_0007332;250;2;1;1.0;0.6;3024;2016;6096384;5174569;895;5174569;530766;529871;5175464;258
ISIC_0008524;300;3;3;100.0;0.6;4288;2848;12212224;4263862;4070;4263862;323767;319697;4267932;345
ISIC_0014428;350;3;3;0.01;0.6;4288;2848;12212224;929739;347;929739;525860;525513;930086;401
ISIC_0003657;200;4;1;0.1;0.6;3024;2016;6096384;1777535;2827;1777535;340261;337434;1780362;227
ISIC_0014712;450;2;1;0.01;0.6;6621;4422;29278062;1137904;17767713;1137904;24292916;6525203;18905617;496
ISIC_0013188;150;2;3;0.1;0.6;3008;2000;6016000;4483250;0;4483250;92544;92544;4483250;147
ISIC_0003657;200;3;3;10.0;0.6;3024;2016;6096384;1786909;1527;1786909;340261;338734;1788436;224
ISIC_0008524;350;3;1;0.1;0.6;4288;2848;12212224;4125469;182;4125469;323767;323585;4125651;392
ISIC_0012547;100;2;3;1.0;0.6;4288;2848;12212224;0;572681;0;572681;0;572681;88
ISIC_0003657;300;2;1;0.01;0.6;3024;2016;6096384;1926731;0;1926731;340261;340261;1926731;316
ISIC_0013188;400;4;2;10.0;0.6;3008;2000;6016000;3249918;0;3249918;92544;92544;3249918;474
ISIC_0013188;150;4;1;100.0;0.6;3008;2000;6016000;4436996;0;4436996;92544;92544;4436996;170
ISIC_0007332;250;1;2;0.1;0.6;3024;2016;6096384;5125315;245;5125315;530766;530521;5125560;247
ISIC_0012547;450;1;1;0.1;0.6;4288;2848;12212224;11290492;60272;11290492;572681;512409;11350764;482
ISIC_0014428;350;1;2;10.0;0.6;4288;2848;12212224;1338154;6259;1338154;525860;519601;1344413;369
ISIC_0008524;200;4;3;1.0;0.6;4288;2848;12212224;4060582;9745;4060582;323767;314022;4070327;238
ISIC_0007332;150;1;1;100.0;0.6;3024;2016;6096384;5525218;0;5525218;530766;530766;5525218;125
ISIC_0013082;50;1;2;1.0;0.6;3872;2592;10036224;3806579;0;3806579;254836;254836;3806579;8
ISIC_0008524;300;4;3;0.1;0.6;4288;2848;12212224;3677719;3094;3677719;323767;320673;3680813;357
ISIC_0003657;400;3;3;100.0;0.6;3024;2016;6096384;1539141;3890;1539141;340261;336371;1543031;465
ISIC_0013188;100;2;3;0.01;0.6;3008;2000;6016000;4871307;0;4871307;92544;92544;4871307;86
ISIC_0007332;400;3;2;100.0;0.6;3024;2016;6096384;4811876;0;4811876;530766;530766;4811876;460
ISIC_0003657;250;3;1;0.1;0.6;3024;2016;6096384;1779549;499;1779549;340261;339762;1780048;272
ISIC_0008524;300;4;1;0.01;0.6;4288;2848;12212224;3768716;0;3768716;323767;323767;3768716;346
ISIC_0007332;400;3;1;100.0;0.6;3024;2016;6096384;4811876;0;4811876;530766;530766;4811876;455
ISIC_0008524;450;3;1;1.0;0.6;4288;2848;12212224;3671217;14328;3671217;323767;309439;3685545;513
ISIC_0014428;50;3;2;0.1;0.6;4288;2848;12212224;3040381;0;3040381;525860;525860;3040381;37
ISIC_0007332;450;4;1;0.1;0.6;3024;2016;6096384;4567499;0;4567499;530766;530766;4567499;527
ISIC_0012547;150;2;3;1.0;0.6;4288;2848;12212224;11557940;0;11557940;572681;572681;11557940;148
ISIC_0014712;300;1;2;0.1;0.6;6621;4422;29278062;1371630;16270448;1371630;24292916;8022468;17642078;307
ISIC_0003657;250;2;1;100.0;0.6;3024;2016;6096384;1825071;296;1825071;340261;339965;1825367;260
ISIC_0003657;50;2;2;100.0;0.6;3024;2016;6096384;2534929;72;2534929;340261;340189;2535001;25
ISIC_0013128;250;4;2;1.0;0.6;3872;2592;10036224;5316556;0;5316556;470897;470897;5316556;293
ISIC_0014712;300;2;2;10.0;0.6;6621;4422;29278062;1318803;17086948;1318803;24292916;7205968;18405751;324
ISIC_0014712;350;3;3;0.1;0.6;6621;4422;29278062;1128469;17536083;1128469;24292916;6756833;18664552;402
ISIC_0013188;200;3;3;10.0;0.6;3008;2000;6016000;4007610;0;4007610;92544;92544;4007610;224
ISIC_0003657;200;2;2;100.0;0.6;3024;2016;6096384;1934522;304;1934522;340261;339957;1934826;205
ISIC_0008524;400;2;3;1.0;0.6;4288;2848;12212224;4010996;3678;4010996;323767;320089;4014674;448
ISIC_0013188;300;4;3;0.1;0.6;3008;2000;6016000;3648925;0;3648925;92544;92544;3648925;357
ISIC_0014428;350;1;2;1.0;0.6;4288;2848;12212224;1296041;1175;1296041;525860;524685;1297216;368
ISIC_0013082;50;4;2;0.1;0.6;3872;2592;10036224;3235414;10573;3235414;254836;244263;3245987;52
ISIC_0013128;100;4;2;0.01;0.6;3872;2592;10036224;6623215;0;6623215;470897;470897;6623215;111
ISIC_0013082;300;4;3;10.0;0.6;3872;2592;10036224;2201177;224;2201177;254836;254612;2201401;359
ISIC_0014712;100;2;1;0.01;0.6;6621;4422;29278062;3374222;12637136;3374222;24292916;11655780;16011358;76
ISIC_0013188;450;1;3;0.01;0.6;3008;2000;6016000;3179537;1806;3179537;92544;90738;3181343;491
ISIC_0014428;450;2;3;0.1;0.6;4288;2848;12212224;843844;0;843844;525860;525860;843844;507
ISIC_0014712;250;1;2;100.0;0.6;6621;4422;29278062;2006263;15387128;2006263;24292916;8905788;17393391;250
ISIC_0003657;300;2;3;0.01;0.6;3024;2016;6096384;1809571;11948;1809571;340261;328313;1821519;326
ISIC_0012547;100;1;1;10.0;0.6;4288;2848;12212224;0;572681;0;572681;0;572681;64
ISIC_0007332;350;3;3;10.0;0.6;3024;2016;6096384;4871964;0;4871964;530766;530766;4871964;404
ISIC_0013128;400;4;3;10.0;0.6;3872;2592;10036224;4483561;0;4483561;470897;470897;4483561;479
ISIC_0012547;300;1;1;100.0;0.6;4288;2848;12212224;11388053;0;11388053;572681;572681;11388053;305
ISIC_0013082;250;4;1;1.0;0.6;3872;2592;10036224;2106119;0;2106119;254836;254836;2106119;288
ISIC_0014623;300;3;1;100.0;0.6;2592;1936;5018112;1080815;1094721;1080815;1937167;842446;2175536;335
ISIC_0012547;100;3;3;0.01;0.6;4288;2848;12212224;0;572681;0;572681;0;572681;101
ISIC_0003657;200;3;2;1.0;0.6;3024;2016;6096384;1843376;359;1843376;340261;339902;1843735;218
ISIC_0012547;250;4;1;10.0;0.6;4288;2848;12212224;11494346;0;11494346;572681;572681;11494346;289
ISIC_0008524;300;3;2;100.0;0.6;4288;2848;12212224;4263968;4070;4263968;323767;319697;4268038;340
ISIC_0013188;50;4;1;0.1;0.6;3008;2000;6016000;5405658;0;5405658;92544;92544;5405658;47
ISIC_0014712;350;1;3;100.0;0.6;6621;4422;29278062;1260483;15587978;1260483;24292916;8704938;16848461;375
ISIC_0014428;250;2;2;0.1;0.6;4288;2848;12212224;1336383;0;1336383;525860;525860;1336383;262
ISIC_0014428;300;1;1;0.1;0.6;4288;2848;12212224;1310869;910;1310869;525860;524950;1311779;302
ISIC_0014428;300;3;3;0.1;0.6;4288;2848;12212224;1181180;845;1181180;525860;525015;1182025;342
ISIC_0013082;150;3;3;100.0;0.6;3872;2592;10036224;2759697;183;2759697;254836;254653;2759880;165
ISIC_0007332;350;1;2;10.0;0.6;3024;2016;6096384;4872093;0;4872093;530766;530766;4872093;369
ISIC_0014623;350;4;2;10.0;0.6;2592;1936;5018112;960264;1144171;960264;1937167;792996;2104435;414
ISIC_0007332;450;2;2;0.01;0.6;3024;2016;6096384;4570889;0;4570889;530766;530766;4570889;501
ISIC_0003657;450;2;1;0.1;0.6;3024;2016;6096384;1640357;0;1640357;340261;340261;1640357;497
ISIC_0014428;350;3;1;0.1;0.6;4288;2848;12212224;1026572;0;1026572;525860;525860;1026572;392
ISIC_0012547;450;1;3;1.0;0.6;4288;2848;12212224;11280839;0;11280839;572681;572681;11280839;493
ISIC_0013082;200;4;2;0.1;0.6;3872;2592;10036224;2034585;1745;2034585;254836;253091;2036330;232
ISIC_0014623;450;1;2;0.1;0.6;2592;1936;5018112;1095280;1033425;1095280;1937167;903742;2128705;487
ISIC_0012547;450;3;3;10.0;0.6;4288;2848;12212224;11227043;108900;11227043;572681;463781;11335943;524
ISIC_0014623;150;1;2;10.0;0.6;2592;1936;5018112;1630317;679462;1630317;1937167;1257705;2309779;129
ISIC_0014428;200;2;3;100.0;0.6;4288;2848;12212224;1500209;999;1500209;525860;524861;1501208;210
ISIC_0013188;450;2;1;100.0;0.6;3008;2000;6016000;3126233;0;3126233;92544;92544;3126233;500
ISIC_0007332;400;1;1;1.0;0.6;3024;2016;6096384;4811969;0;4811969;530766;530766;4811969;423
ISIC_0013128;250;1;1;0.1;0.6;3872;2592;10036224;5435101;0;5435101;470897;470897;5435101;242
ISIC_0013188;50;1;3;0.1;0.6;3008;2000;6016000;5404245;0;5404245;92544;92544;5404245;12
ISIC_0012547;200;4;1;1.0;0.6;4288;2848;12212224;11263431;61668;11263431;572681;511013;11325099;228
ISIC_0013188;400;4;1;0.01;0.6;3008;2000;6016000;3229378;49;3229378;92544;92495;3229427;466
ISIC_0013128;150;4;1;0.01;0.6;3872;2592;10036224;5738517;0;5738517;470897;470897;5738517;166
ISIC_0003657;250;2;3;0.01;0.6;3024;2016;6096384;2001895;7668;2001895;340261;332593;2009563;266
ISIC_0008524;250;1;3;10.0;0.6;4288;2848;12212224;4539491;7441;4539491;323767;316326;4546932;254
ISIC_0007332;100;2;2;100.0;0.6;3024;2016;6096384;0;530766;0;530766;0;530766;85
ISIC_0008524;150;1;1;100.0;0.6;4288;2848;12212224;4994089;5649;4994089;323767;318118;4999738;125
ISIC_0013082;450;2;3;0.1;0.6;3872;2592;10036224;1504929;1547;1504929;254836;253289;1506476;507
ISIC_0013082;250;3;2;0.01;0.6;3872;2592;10036224;1996786;6087;1996786;254836;248749;2002873;276
ISIC_0014712;200;1;3;10.0;0.6;6621;4422;29278062;1419760;14624010;1419760;24292916;9668906;16043770;194
ISIC_0013128;300;2;1;1.0;0.6;3872;2592;10036224;5142630;55;5142630;470897;470842;5142685;318
ISIC_0014712;450;1;1;1.0;0.6;6621;4422;29278062;1065523;17255220;1065523;24292916;7037696;18320743;483
ISIC_0012547;350;4;3;1.0;0.6;4288;2848;12212224;11254415;106338;11254415;572681;466343;11360753;418
ISIC_0008524;50;4;2;0.01;0.6;4288;2848;12212224;6353138;22490;6353138;323767;301277;6375628;51
ISIC_0013188;150;3;1;0.1;0.6;3008;2000;6016000;4431557;0;4431557;92544;92544;4431557;152
ISIC_0013128;250;3;3;10.0;0.6;3872;2592;10036224;5441793;0;5441793;470897;470897;5441793;284
ISIC_0012547;400;2;1;0.1;0.6;4288;2848;12212224;11232045;0;11232045;572681;572681;11232045;437
ISIC_0008524;100;3;1;100.0;0.6;4288;2848;12212224;5531429;4774;5531429;323767;318993;5536203;95
ISIC_0007332;100;4;1;100.0;0.6;3024;2016;6096384;0;530766;0;530766;0;530766;110
ISIC_0012547;400;2;2;100.0;0.6;4288;2848;12212224;11219541;0;11219541;572681;572681;11219541;445
ISIC_0013082;300;2;2;10.0;0.6;3872;2592;10036224;2201295;224;2201295;254836;254612;2201519;324
ISIC_0014712;100;1;3;0.1;0.6;6621;4422;29278062;3534853;10881297;3534853;24292916;13411619;14416150;72
ISIC_0012547;100;2;2;100.0;0.6;4288;2848;12212224;0;572681;0;572681;0;572681;85
ISIC_0014712;400;3;2;1.0;0.6;6621;4422;29278062;1239185;17659058;1239185;24292916;6633858;18898243;458
ISIC_0013188;200;2;3;100.0;0.6;3008;2000;6016000;4007611;0;4007611;92544;92544;4007611;210
ISIC_0003657;200;3;2;0.1;0.6;3024;2016;6096384;1915738;0;1915738;340261;340261;1915738;217
ISIC_0003657;250;4;3;0.1;0.6;3024;2016;6096384;1759320;725;1759320;340261;339536;1760045;297
ISIC_0014623;450;2;3;1.0;0.6;2592;1936;5018112;1000832;1111013;1000832;1937167;826154;2111845;508
ISIC_0008524;450;3;1;0.01;0.6;4288;2848;12212224;3807135;2549;3807135;323767;321218;3809684;511
ISIC_0013082;50;4;2;1.0;0.6;3872;2592;10036224;3805330;0;3805330;254836;254836;3805330;53
ISIC_0003657;350;4;1;0.01;0.6;3024;2016;6096384;1679810;0;1679810;340261;340261;1679810;406
ISIC_0007332;50;2;3;100.0;0.6;3024;2016;6096384;5150117;0;5150117;530766;530766;5150117;30
ISIC_0013082;200;1;2;10.0;0.6;3872;2592;10036224;2123906;200;2123906;254836;254636;2124106;189
ISIC_0014428;250;1;2;0.1;0.6;4288;2848;12212224;1391287;0;1391287;525860;525860;1391287;247
ISIC_0012547;150;2;1;100.0;0.6;4288;2848;12212224;11558318;0;11558318;572681;572681;11558318;140
ISIC_0003657;300;4;3;0.1;0.6;3024;2016;6096384;1572730;798;1572730;340261;339463;1573528;357
ISIC_0003657;150;4;1;10.0;0.6;3024;2016;6096384;1972507;1986;1972507;340261;338275;1974493;169
ISIC_0013082;450;3;3;1.0;0.6;3872;2592;10036224;1785425;0;1785425;254836;254836;1785425;523
ISIC_0013128;50;1;2;0.1;0.6;3872;2592;10036224;7283832;0;7283832;470897;470897;7283832;7
ISIC_0007332;50;3;3;10.0;0.6;3024;2016;6096384;5150111;0;5150111;530766;530766;5150111;44
ISIC_0014623;350;3;2;100.0;0.6;2592;1936;5018112;1040317;1054531;1040317;1937167;882636;2094848;400
ISIC_0012547;300;2;2;1.0;0.6;4288;2848;12212224;11387980;40551;11387980;572681;532130;11428531;323
ISIC_0014623;100;1;2;0.01;0.6;2592;1936;5018112;1761231;588738;1761231;1937167;1348429;2349969;66
ISIC_0013188;350;1;3;0.1;0.6;3008;2000;6016000;3431232;0;3431232;92544;92544;3431232;372
ISIC_0013128;150;4;1;1.0;0.6;3872;2592;10036224;5678570;0;5678570;470897;470897;5678570;168
ISIC_0013128;250;4;2;100.0;0.6;3872;2592;10036224;5316904;0;5316904;470897;470897;5316904;295
ISIC_0014428;350;2;3;10.0;0.6;4288;2848;12212224;1232873;6259;1232873;525860;519601;1239132;389
ISIC_0013188;200;3;2;1.0;0.6;3008;2000;6016000;4058875;0;4058875;92544;92544;4058875;218
ISIC_0012547;250;3;1;0.01;0.6;4288;2848;12212224;11564464;0;11564464;572681;572681;11564464;271
ISIC_0012547;50;2;1;0.01;0.6;4288;2848;12212224;0;572681;0;572681;0;572681;16
ISIC_0013128;250;3;2;100.0;0.6;3872;2592;10036224;5441794;0;5441794;470897;470897;5441794;280
ISIC_0003657;50;4;3;0.01;0.6;3024;2016;6096384;2709319;10768;2709319;340261;329493;2720087;56
ISIC_0007332;50;2;2;1.0;0.6;3024;2016;6096384;5117288;0;5117288;530766;530766;5117288;23
ISIC_0014428;50;3;3;0.01;0.6;4288;2848;12212224;2644465;7028;2644465;525860;518832;2651493;41
ISIC_0014428;300;2;3;10.0;0.6;4288;2848;12212224;1252282;1843;1252282;525860;524017;1254125;329
ISIC_0014623;50;4;2;0.1;0.6;2592;1936;5018112;2046038;441166;2046038;1937167;1496001;2487204;52
ISIC_0013128;250;4;1;1.0;0.6;3872;2592;10036224;5316324;0;5316324;470897;470897;5316324;288
ISIC_0013082;450;4;1;0.1;0.6;3872;2592;10036224;1538874;0;1538874;254836;254836;1538874;527
ISIC_0013188;200;3;2;0.01;0.6;3008;2000;6016000;4301637;0;4301637;92544;92544;4301637;216
ISIC_0013188;50;2;1;100.0;0.6;3008;2000;6016000;5061939;0;5061939;92544;92544;5061939;20
ISIC_0013188;100;1;3;0.1;0.6;3008;2000;6016000;4926537;0;4926537;92544;92544;4926537;72
ISIC_0003657;400;3;2;1.0;0.6;3024;2016;6096384;1539130;4152;1539130;340261;336109;1543282;458
ISIC_0007332;300;2;1;10.0;0.6;3024;2016;6096384;5088140;0;5088140;530766;530766;5088140;319
ISIC_0008524;300;4;3;100.0;0.6;4288;2848;12212224;3661439;4070;3661439;323767;319697;3665509;360
ISIC_0013128;350;1;1;1.0;0.6;3872;2592;10036224;5025589;0;5025589;470897;470897;5025589;363
ISIC_0014712;250;3;3;1.0;0.6;6621;4422;29278062;1784874;17065301;1784874;24292916;7227615;18850175;283
ISIC_0013128;450;4;2;1.0;0.6;3872;2592;10036224;4438395;0;4438395;470897;470897;4438395;533
ISIC_0008524;50;4;3;0.1;0.6;4288;2848;12212224;6018678;3580;6018678;323767;320187;6022258;57
ISIC_0007332;150;1;2;10.0;0.6;3024;2016;6096384;5525218;0;5525218;530766;530766;5525218;129
ISIC_0013128;100;2;3;10.0;0.6;3872;2592;10036224;6775957;0;6775957;470897;470897;6775957;89
ISIC_0014623;350;4;1;10.0;0.6;2592;1936;5018112;945222;1143971;945222;1937167;793196;2089193;409
ISIC_0014712;50;1;2;0.01;0.6;6621;4422;29278062;3822716;10045080;3822716;24292916;14247836;13867796;6
ISIC_0013188;450;4;1;1.0;0.6;3008;2000;6016000;3152654;342;3152654;92544;92202;3152996;528
ISIC_0014623;50;1;2;100.0;0.6;2592;1936;5018112;2352648;423093;2352648;1937167;1514074;2775741;10
ISIC_0003657;200;4;1;1.0;0.6;3024;2016;6096384;1693611;901;1693611;340261;339360;1694512;228
ISIC_0014428;450;2;3;10.0;0.6;4288;2848;12212224;1156198;8163;1156198;525860;517697;1164361;509
ISIC_0014623;350;4;2;0.01;0.6;2592;1936;5018112;961788;1120791;961788;1937167;816376;2082579;411
ISIC_0014712;250;4;3;0.1;0.6;6621;4422;29278062;1787168;18084701;1787168;24292916;6208215;19871869;297
ISIC_0003657;200;4;3;10.0;0.6;3024;2016;6096384;1664668;1959;1664668;340261;338302;1666627;239
ISIC_0014623;200;2;1;1.0;0.6;2592;1936;5018112;1311094;843747;1311094;1937167;1093420;2154841;198
ISIC_0013188;150;2;2;1.0;0.6;3008;2000;6016000;4476907;0;4476907;92544;92544;4476907;143
ISIC_0012547;300;4;3;0.1;0.6;4288;2848;12212224;11383507;174210;11383507;572681;398471;11557717;357
ISIC_0013082;250;3;1;10.0;0.6;3872;2592;10036224;2106229;0;2106229;254836;254836;2106229;274
ISIC_0013188;450;2;1;0.1;0.6;3008;2000;6016000;3118994;0;3118994;92544;92544;3118994;497
ISIC_0003657;200;3;2;10.0;0.6;3024;2016;6096384;1814255;1527;1814255;340261;338734;1815782;219
ISIC_0003657;350;3;2;100.0;0.6;3024;2016;6096384;1613738;2927;1613738;340261;337334;1616665;400
ISIC_0007332;100;3;2;1.0;0.6;3024;2016;6096384;0;530766;0;530766;0;530766;98
ISIC_0014623;350;3;3;0.01;0.6;2592;1936;5018112;1081383;1086987;1081383;1937167;850180;2168370;401
ISIC_0013082;200;2;2;100.0;0.6;3872;2592;10036224;2123931;200;2123931;254836;254636;2124131;205
ISIC_0013188;400;1;3;0.1;0.6;3008;2000;6016000;3204879;0;3204879;92544;92544;3204879;432
ISIC_0012547;450;2;3;0.1;0.6;4288;2848;12212224;11233893;57615;11233893;572681;515066;11291508;507
ISIC_0007332;100;4;3;1.0;0.6;3024;2016;6096384;0;530766;0;530766;0;530766;118
ISIC_0014428;350;4;3;10.0;0.6;4288;2848;12212224;1197904;6259;1197904;525860;519601;1204163;419
ISIC_0003657;250;3;2;100.0;0.6;3024;2016;6096384;1772118;296;1772118;340261;339965;1772414;280
ISIC_0014623;150;2;2;1.0;0.6;2592;1936;5018112;1540493;753261;1540493;1937167;1183906;2293754;143
ISIC_0014623;350;3;1;1.0;0.6;2592;1936;5018112;1040513;1054235;1040513;1937167;882932;2094748;393
ISIC_0013128;200;2;2;10.0;0.6;3872;2592;10036224;5660983;0;5660983;470897;470897;5660983;204
ISIC_0007332;150;4;2;1.0;0.6;3024;2016;6096384;5525218;0;5525218;530766;530766;5525218;173
ISIC_0014712;350;2;1;100.0;0.6;6621;4422;29278062;1252247;17088113;1252247;24292916;7204803;18340360;380
ISIC_0007332;200;1;2;10.0;0.6;3024;2016;6096384;5168793;0;5168793;530766;530766;5168793;189
ISIC_0013082;100;4;3;10.0;0.6;3872;2592;10036224;2998222;0;2998222;254836;254836;2998222;119
ISIC_0013188;100;4;1;10.0;0.6;3008;2000;6016000;4739056;0;4739056;92544;92544;4739056;109
ISIC_0007332;400;3;3;0.1;0.6;3024;2016;6096384;4735422;0;4735422;530766;530766;4735422;462
ISIC_0013188;300;4;2;100.0;0.6;3008;2000;6016000;3655752;45;3655752;92544;92499;3655797;355
ISIC_0013082;250;4;1;0.1;0.6;3872;2592;10036224;1988826;0;1988826;254836;254836;1988826;287
ISIC_0013188;50;3;1;100.0;0.6;3008;2000;6016000;5061940;0;5061940;92544;92544;5061940;35
ISIC_0012547;50;3;3;0.01;0.6;4288;2848;12212224;0;572681;0;572681;0;572681;41
ISIC_0008524;100;2;2;1.0;0.6;4288;2848;12212224;5639279;1896;5639279;323767;321871;5641175;83
ISIC_0014623;450;3;3;0.01;0.6;2592;1936;5018112;916457;1171821;916457;1937167;765346;2088278;521
ISIC_0008524;150;4;2;1.0;0.6;4288;2848;12212224;4319718;2022;4319718;323767;321745;4321740;173
ISIC_0014428;50;2;3;1.0;0.6;4288;2848;12212224;3159534;1651;3159534;525860;524209;3161185;28
ISIC_0007332;300;2;3;1.0;0.6;3024;2016;6096384;5088362;0;5088362;530766;530766;5088362;328
ISIC_0014712;100;3;1;10.0;0.6;6621;4422;29278062;3327017;12431259;3327017;24292916;11861657;15758276;94
ISIC_0014712;300;3;2;1.0;0.6;6621;4422;29278062;1314379;17477788;1314379;24292916;6815128;18792167;338
ISIC_0007332;50;3;1;100.0;0.6;3024;2016;6096384;5139556;0;5139556;530766;530766;5139556;35
ISIC_0014712;400;4;1;0.1;0.6;6621;4422;29278062;1198532;19172897;1198532;24292916;5120019;20371429;467
ISIC_0003657;150;3;2;0.1;0.6;3024;2016;6096384;2172264;1295;2172264;340261;338966;2173559;157
ISIC_0007332;300;4;1;10.0;0.6;3024;2016;6096384;5067694;0;5067694;530766;530766;5067694;349
ISIC_0013128;400;2;1;0.1;0.6;3872;2592;10036224;4676503;0;4676503;470897;470897;4676503;437
ISIC_0014712;400;2;1;0.01;0.6;6621;4422;29278062;1219102;17049658;1219102;24292916;7243258;18268760;436
ISIC_0008524;250;1;3;0.1;0.6;4288;2848;12212224;4605784;4565;4605784;323767;319202;4610349;252
ISIC_0014623;200;4;2;0.01;0.6;2592;1936;5018112;1196137;942231;1196137;1937167;994936;2138368;231
ISIC_0014712;50;3;3;0.1;0.6;6621;4422;29278062;2458332;13461563;2458332;24292916;10831353;15919895;42
ISIC_0008524;350;1;1;100.0;0.6;4288;2848;12212224;4242252;277;4242252;323767;323490;4242529;365
ISIC_0013128;300;2;2;10.0;0.6;3872;2592;10036224;5142298;39;5142298;470897;470858;5142337;324
ISIC_0013128;400;3;2;100.0;0.6;3872;2592;10036224;4609415;0;4609415;470897;470897;4609415;460
ISIC_0008524;250;1;2;0.1;0.6;4288;2848;12212224;4605182;4509;4605182;323767;319258;4609691;247
ISIC_0007332;200;1;2;0.01;0.6;3024;2016;6096384;5210638;0;5210638;530766;530766;5210638;186
ISIC_0012547;50;3;3;100.0;0.6;4288;2848;12212224;10811912;0;10811912;572681;572681;10811912;45
ISIC_0013082;300;4;1;0.1;0.6;3872;2592;10036224;2054443;0;2054443;254836;254836;2054443;347
ISIC_0013128;400;3;3;10.0;0.6;3872;2592;10036224;4609421;0;4609421;470897;470897;4609421;464
ISIC_0013188;150;1;2;10.0;0.6;3008;2000;6016000;4477530;0;4477530;92544;92544;4477530;129
ISIC_0013082;50;4;3;10.0;0.6;3872;2592;10036224;3809129;0;3809129;254836;254836;3809129;59
ISIC_0013128;50;1;1;0.01;0.6;3872;2592;10036224;7902262;0;7902262;470897;470897;7902262;1
ISIC_0013082;400;1;1;10.0;0.6;3872;2592;10036224;1809382;0;1809382;254836;254836;1809382;424
ISIC_0003657;350;3;3;10.0;0.6;3024;2016;6096384;1613851;2927;1613851;340261;337334;1616778;404
ISIC_0014623;250;4;2;100.0;0.6;2592;1936;5018112;1086094;1047131;1086094;1937167;890036;2133225;295
ISIC_0008524;450;4;1;0.01;0.6;4288;2848;12212224;2948920;2539;2948920;323767;321228;2951459;526
ISIC_0013128;300;3;1;10.0;0.6;3872;2592;10036224;5070889;39;5070889;470897;470858;5070928;334
ISIC_0007332;350;2;3;0.01;0.6;3024;2016;6096384;4791266;0;4791266;530766;530766;4791266;386
ISIC_0013082;150;1;3;0.01;0.6;3872;2592;10036224;2424774;6911;2424774;254836;247925;2431685;131
ISIC_0003657;250;3;1;100.0;0.6;3024;2016;6096384;1772118;296;1772118;340261;339965;1772414;275
ISIC_0007332;250;4;3;100.0;0.6;3024;2016;6096384;5150273;895;5150273;530766;529871;5151168;300
ISIC_0013082;350;2;2;10.0;0.6;3872;2592;10036224;1955525;0;1955525;254836;254836;1955525;384
ISIC_0014428;300;2;3;1.0;0.6;4288;2848;12212224;1165881;2301;1165881;525860;523559;1168182;328
ISIC_0014428;350;2;1;0.01;0.6;4288;2848;12212224;1256530;60;1256530;525860;525800;1256590;376
ISIC_0003657;100;3;1;0.1;0.6;3024;2016;6096384;2539174;76;2539174;340261;340185;2539250;92
ISIC_0014712;300;1;2;100.0;0.6;6621;4422;29278062;1326291;15822067;1326291;24292916;8470849;17148358;310
ISIC_0014623;50;3;2;0.01;0.6;2592;1936;5018112;2109041;487214;2109041;1937167;1449953;2596255;36
ISIC_0014712;350;4;2;0.1;0.6;6621;4422;29278062;1125321;18364874;1125321;24292916;5928042;19490195;412
ISIC_0014428;400;1;2;10.0;0.6;4288;2848;12212224;1256533;1424;1256533;525860;524436;1257957;429
ISIC_0003657;400;2;3;10.0;0.6;3024;2016;6096384;1610024;3890;1610024;340261;336371;1613914;449
ISIC_0007332;50;4;1;10.0;0.6;3024;2016;6096384;5142878;0;5142878;530766;530766;5142878;49
ISIC_0013188;250;3;1;100.0;0.6;3008;2000;6016000;3820281;0;3820281;92544;92544;3820281;275
ISIC_0013188;400;3;2;0.1;0.6;3008;2000;6016000;3116075;0;3116075;92544;92544;3116075;457
ISIC_0012547;150;2;3;0.01;0.6;4288;2848;12212224;0;572681;0;572681;0;572681;146
ISIC_0013082;150;1;2;100.0;0.6;3872;2592;10036224;2759697;183;2759697;254836;254653;2759880;130
ISIC_0012547;250;3;2;0.01;0.6;4288;2848;12212224;11563227;0;11563227;572681;572681;11563227;276
ISIC_0007332;200;1;1;10.0;0.6;3024;2016;6096384;5168918;0;5168918;530766;530766;5168918;184
ISIC_0007332;400;3;3;100.0;0.6;3024;2016;6096384;4811754;0;4811754;530766;530766;4811754;465
ISIC_0014712;250;2;2;1.0;0.6;6621;4422;29278062;1784876;16828386;1784876;24292916;7464530;18613262;263
ISIC_0013128;350;4;2;10.0;0.6;3872;2592;10036224;4753804;0;4753804;470897;470897;4753804;414
ISIC_0013082;450;3;1;100.0;0.6;3872;2592;10036224;1722804;1608;1722804;254836;253228;1724412;515
ISIC_0013082;250;2;3;100.0;0.6;3872;2592;10036224;2106430;0;2106430;254836;254836;2106430;270
ISIC_0008524;450;1;1;10.0;0.6;4288;2848;12212224;4007581;18436;4007581;323767;305331;4026017;484
ISIC_0013188;200;4;3;100.0;0.6;3008;2000;6016000;3977682;0;3977682;92544;92544;3977682;240
ISIC_0012547;400;3;2;0.1;0.6;4288;2848;12212224;11260194;65998;11260194;572681;506683;11326192;457
ISIC_0013188;150;4;1;1.0;0.6;3008;2000;6016000;4396403;0;4396403;92544;92544;4396403;168
ISIC_0014623;250;3;3;10.0;0.6;2592;1936;5018112;1187982;1026842;1187982;1937167;910325;2214824;284
ISIC_0014712;150;4;2;0.01;0.6;6621;4422;29278062;1690072;16183838;1690072;24292916;8109078;17873910;171
ISIC_0013128;450;2;2;10.0;0.6;3872;2592;10036224;4668657;0;4668657;470897;470897;4668657;504
ISIC_0013082;50;2;1;0.01;0.6;3872;2592;10036224;3870303;0;3870303;254836;254836;3870303;16
ISIC_0014623;100;1;1;100.0;0.6;2592;1936;5018112;1678080;581086;1678080;1937167;1356081;2259166;65
ISIC_0014623;250;1;2;10.0;0.6;2592;1936;5018112;1407618;890835;1407618;1937167;1046332;2298453;249
ISIC_0007332;200;4;3;100.0;0.6;3024;2016;6096384;5168918;0;5168918;530766;530766;5168918;240
ISIC_0007332;350;3;1;0.01;0.6;3024;2016;6096384;4842312;0;4842312;530766;530766;4842312;391
ISIC_0007332;150;3;1;10.0;0.6;3024;2016;6096384;5525218;0;5525218;530766;530766;5525218;154
ISIC_0014623;300;2;2;10.0;0.6;2592;1936;5018112;1113840;1061439;1113840;1937167;875728;2175279;324
ISIC_0008524;250;2;3;0.1;0.6;4288;2848;12212224;4634668;5555;4634668;323767;318212;4640223;267
ISIC_0013188;150;1;3;100.0;0.6;3008;2000;6016000;4477530;0;4477530;92544;92544;4477530;135
ISIC_0013188;250;2;2;0.1;0.6;3008;2000;6016000;3752896;0;3752896;92544;92544;3752896;262
ISIC_0014623;200;2;3;0.1;0.6;2592;1936;5018112;1310516;810290;1310516;1937167;1126877;2120806;207
ISIC_0007332;400;1;1;10.0;0.6;3024;2016;6096384;4811876;0;4811876;530766;530766;4811876;424
ISIC_0007332;150;1;3;1.0;0.6;3024;2016;6096384;5525218;0;5525218;530766;530766;5525218;133
ISIC_0003657;100;3;1;100.0;0.6;3024;2016;6096384;2439491;30;2439491;340261;340231;2439521;95
ISIC_0003657;100;4;3;1.0;0.6;3024;2016;6096384;2311449;346;2311449;340261;339915;2311795;118
ISIC_0012547;400;3;2;100.0;0.6;4288;2848;12212224;11191891;61250;11191891;572681;511431;11253141;460
ISIC_0013082;350;3;1;0.1;0.6;3872;2592;10036224;1706291;0;1706291;254836;254836;1706291;392
ISIC_0014623;450;1;1;10.0;0.6;2592;1936;5018112;1111345;1023020;1111345;1937167;914147;2134365;484
ISIC_0014428;350;4;1;0.01;0.6;4288;2848;12212224;1218788;100;1218788;525860;525760;1218888;406
ISIC_0003657;250;2;1;10.0;0.6;3024;2016;6096384;1825069;296;1825069;340261;339965;1825365;259
ISIC_0013188;450;1;2;1.0;0.6;3008;2000;6016000;3165396;673;3165396;92544;91871;3166069;488
ISIC_0008524;50;2;1;10.0;0.6;4288;2848;12212224;6157030;12093;6157030;323767;311674;6169123;19
ISIC_0014623;250;1;3;0.01;0.6;2592;1936;5018112;1351143;786139;1351143;1937167;1151028;2137282;251
ISIC_0012547;200;1;3;1.0;0.6;4288;2848;12212224;11267262;0;11267262;572681;572681;11267262;193
ISIC_0008524;100;3;3;0.1;0.6;4288;2848;12212224;5569687;8579;5569687;323767;315188;5578266;102
ISIC_0012547;400;1;2;1.0;0.6;4288;2848;12212224;11250262;0;11250262;572681;572681;11250262;428
ISIC_0014428;400;3;3;100.0;0.6;4288;2848;12212224;1108993;2796;1108993;525860;523064;1111789;465
ISIC_0003657;250;4;3;100.0;0.6;3024;2016;6096384;1642829;296;1642829;340261;339965;1643125;300
ISIC_0014428;350;2;1;10.0;0.6;4288;2848;12212224;1232873;6259;1232873;525860;519601;1239132;379
ISIC_0003657;150;2;1;0.1;0.6;3024;2016;6096384;2266269;5594;2266269;340261;334667;2271863;137
ISIC_0007332;200;4;2;1.0;0.6;3024;2016;6096384;5166314;0;5166314;530766;530766;5166314;233
ISIC_0013188;350;1;1;0.1;0.6;3008;2000;6016000;3408623;0;3408623;92544;92544;3408623;362
ISIC_0003657;450;2;1;0.01;0.6;3024;2016;6096384;1676642;0;1676642;340261;340261;1676642;496
ISIC_0013082;50;1;1;1.0;0.6;3872;2592;10036224;3806481;0;3806481;254836;254836;3806481;3
ISIC_0014623;100;1;3;0.01;0.6;2592;1936;5018112;1714843;596373;1714843;1937167;1340794;2311216;71
ISIC_0014428;250;3;1;0.01;0.6;4288;2848;12212224;1529325;0;1529325;525860;525860;1529325;271
ISIC_0008524;400;3;1;10.0;0.6;4288;2848;12212224;3931378;13085;3931378;323767;310682;3944463;454
ISIC_0013082;350;4;2;100.0;0.6;3872;2592;10036224;1955510;0;1955510;254836;254836;1955510;415
ISIC_0007332;150;3;2;0.01;0.6;3024;2016;6096384;5484921;0;5484921;530766;530766;5484921;156
ISIC_0014623;200;3;1;0.01;0.6;2592;1936;5018112;1261580;927071;1261580;1937167;1010096;2188651;211
ISIC_0014623;250;1;1;0.01;0.6;2592;1936;5018112;1387379;816818;1387379;1937167;1120349;2204197;241
ISIC_0014428;350;3;3;100.0;0.6;4288;2848;12212224;1232873;6259;1232873;525860;519601;1239132;405
ISIC_0003657;50;2;3;0.1;0.6;3024;2016;6096384;3523389;472;3523389;340261;339789;3523861;27
ISIC_0014428;100;3;2;0.1;0.6;4288;2848;12212224;2042666;0;2042666;525860;525860;2042666;97
ISIC_0007332;250;1;3;10.0;0.6;3024;2016;6096384;5174609;895;5174609;530766;529871;5175504;254
ISIC_0014428;400;3;1;0.01;0.6;4288;2848;12212224;1151154;5737;1151154;525860;520123;1156891;451
ISIC_0014623;350;1;3;100.0;0.6;2592;1936;5018112;1183121;941062;1183121;1937167;996105;2124183;375
ISIC_0012547;400;2;3;1.0;0.6;4288;2848;12212224;11219686;0;11219686;572681;572681;11219686;448
ISIC_0013082;250;3;1;100.0;0.6;3872;2592;10036224;2106230;0;2106230;254836;254836;2106230;275
ISIC_0014428;350;3;2;10.0;0.6;4288;2848;12212224;1232873;6259;1232873;525860;519601;1239132;399
ISIC_0007332;100;1;2;0.01;0.6;3024;2016;6096384;0;530766;0;530766;0;530766;66
ISIC_0008524;150;3;1;10.0;0.6;4288;2848;12212224;4910871;5649;4910871;323767;318118;4916520;154
ISIC_0013128;450;4;1;1.0;0.6;3872;2592;10036224;4438215;0;4438215;470897;470897;4438215;528
ISIC_0013188;450;3;2;0.01;0.6;3008;2000;6016000;3218551;0;3218551;92544;92544;3218551;516
ISIC_0012547;300;1;2;0.1;0.6;4288;2848;12212224;11367101;0;11367101;572681;572681;11367101;307
ISIC_0008524;50;1;1;0.1;0.6;4288;2848;12212224;7563449;0;7563449;323767;323767;7563449;2
ISIC_0014623;400;4;1;0.01;0.6;2592;1936;5018112;959283;1168845;959283;1937167;768322;2128128;466
ISIC_0014623;250;2;1;0.1;0.6;2592;1936;5018112;1239411;987006;1239411;1937167;950161;2226417;257
ISIC_0012547;300;4;3;100.0;0.6;4288;2848;12212224;11305117;163216;11305117;572681;409465;11468333;360
ISIC_0013128;150;3;1;1.0;0.6;3872;2592;10036224;5745612;0;5745612;470897;470897;5745612;153
ISIC_0003657;50;4;1;1.0;0.6;3024;2016;6096384;2177370;55;2177370;340261;340206;2177425;48
ISIC_0008524;150;3;3;100.0;0.6;4288;2848;12212224;4911439;5649;4911439;323767;318118;4917088;165
ISIC_0014428;400;4;2;100.0;0.6;4288;2848;12212224;1078368;2797;1078368;525860;523063;1081165;475
ISIC_0003657;450;1;1;1.0;0.6;3024;2016;6096384;1707112;743;1707112;340261;339518;1707855;483
ISIC_0012547;250;1;2;100.0;0.6;4288;2848;12212224;11494346;0;11494346;572681;572681;11494346;250
ISIC_0014428;350;3;2;1.0;0.6;4288;2848;12212224;1161525;8384;1161525;525860;517476;1169909;398
ISIC_0008524;150;4;3;10.0;0.6;4288;2848;12212224;4173003;5649;4173003;323767;318118;4178652;179
ISIC_0014623;50;3;3;1.0;0.6;2592;1936;5018112;2054937;437115;2054937;1937167;1500052;2492052;43
ISIC_0014428;400;1;3;10.0;0.6;4288;2848;12212224;1256533;1424;1256533;525860;524436;1257957;434
ISIC_0013082;150;3;2;0.01;0.6;3872;2592;10036224;2855191;0;2855191;254836;254836;2855191;156
ISIC_0013082;250;2;2;10.0;0.6;3872;2592;10036224;2106429;0;2106429;254836;254836;2106429;264
ISIC_0008524;100;1;1;100.0;0.6;4288;2848;12212224;5653343;4774;5653343;323767;318993;5658117;65
ISIC_0007332;450;2;1;0.1;0.6;3024;2016;6096384;4541497;0;4541497;530766;530766;4541497;497
ISIC_0013188;450;3;3;10.0;0.6;3008;2000;6016000;3126156;0;3126156;92544;92544;3126156;524
ISIC_0013082;200;4;1;0.01;0.6;3872;2592;10036224;2414085;1001;2414085;254836;253835;2415086;226
ISIC_0008524;300;2;3;10.0;0.6;4288;2848;12212224;4395438;4070;4395438;323767;319697;4399508;329
ISIC_0013188;150;3;2;10.0;0.6;3008;2000;6016000;4477346;0;4477346;92544;92544;4477346;159
ISIC_0014623;300;4;1;100.0;0.6;2592;1936;5018112;1030370;1128003;1030370;1937167;809164;2158373;350
ISIC_0014712;350;3;1;0.01;0.6;6621;4422;29278062;1133349;17271957;1133349;24292916;7020959;18405306;391
ISIC_0003657;350;3;3;100.0;0.6;3024;2016;6096384;1613853;2927;1613853;340261;337334;1616780;405
ISIC_0014428;50;3;1;100.0;0.6;4288;2848;12212224;2715664;1211;2715664;525860;524649;2716875;35
ISIC_0014428;100;3;1;0.01;0.6;4288;2848;12212224;2496175;0;2496175;525860;525860;2496175;91
ISIC_0014712;150;1;1;0.1;0.6;6621;4422;29278062;1951998;14054483;1951998;24292916;10238433;16006481;122
ISIC_0007332;150;1;3;10.0;0.6;3024;2016;6096384;5525218;0;5525218;530766;530766;5525218;134
ISIC_0008524;450;2;2;1.0;0.6;4288;2848;12212224;3892066;14408;3892066;323767;309359;3906474;503
ISIC_0003657;250;1;1;100.0;0.6;3024;2016;6096384;2034268;296;2034268;340261;339965;2034564;245
ISIC_0014712;200;2;2;1.0;0.6;6621;4422;29278062;1518660;16464400;1518660;24292916;7828516;17983060;203
ISIC_0003657;300;4;1;100.0;0.6;3024;2016;6096384;1540427;2883;1540427;340261;337378;1543310;350
ISIC_0013082;450;3;2;100.0;0.6;3872;2592;10036224;1722804;1608;1722804;254836;253228;1724412;520
ISIC_0013128;150;3;3;0.1;0.6;3872;2592;10036224;5797190;0;5797190;470897;470897;5797190;162
ISIC_0012547;350;1;2;10.0;0.6;4288;2848;12212224;11289045;36400;11289045;572681;536281;11325445;369
ISIC_0014623;400;3;3;0.01;0.6;2592;1936;5018112;1020616;1124666;1020616;1937167;812501;2145282;461
ISIC_0007332;250;2;3;1.0;0.6;3024;2016;6096384;5174766;895;5174766;530766;529871;5175661;268
ISIC_0012547;200;4;2;0.01;0.6;4288;2848;12212224;11559421;0;11559421;572681;572681;11559421;231
ISIC_0012547;250;2;3;0.1;0.6;4288;2848;12212224;11535439;0;11535439;572681;572681;11535439;267
ISIC_0007332;150;3;1;0.01;0.6;3024;2016;6096384;5501124;0;5501124;530766;530766;5501124;151
ISIC_0013128;350;4;3;1.0;0.6;3872;2592;10036224;4754308;0;4754308;470897;470897;4754308;418
ISIC_0013128;450;4;3;1.0;0.6;3872;2592;10036224;4438584;0;4438584;470897;470897;4438584;538
ISIC_0008524;250;3;2;0.1;0.6;4288;2848;12212224;4427078;6316;4427078;323767;317451;4433394;277
ISIC_0012547;450;1;2;100.0;0.6;4288;2848;12212224;11281493;0;11281493;572681;572681;11281493;490
ISIC_0003657;350;4;2;1.0;0.6;3024;2016;6096384;1523788;2927;1523788;340261;337334;1526715;413
ISIC_0013082;400;1;3;10.0;0.6;3872;2592;10036224;1809398;0;1809398;254836;254836;1809398;434
ISIC_0008524;150;1;2;10.0;0.6;4288;2848;12212224;4994089;5649;4994089;323767;318118;4999738;129
ISIC_0014428;400;2;2;10.0;0.6;4288;2848;12212224;1140318;2797;1140318;525860;523063;1143115;444
ISIC_0008524;300;3;1;10.0;0.6;4288;2848;12212224;4263919;4070;4263919;323767;319697;4267989;334
ISIC_0012547;100;4;2;1.0;0.6;4288;2848;12212224;0;572681;0;572681;0;572681;113
ISIC_0003657;300;1;2;10.0;0.6;3024;2016;6096384;1919027;2337;1919027;340261;337924;1921364;309
ISIC_0013188;150;3;3;100.0;0.6;3008;2000;6016000;4477530;0;4477530;92544;92544;4477530;165
ISIC_0014428;150;3;1;100.0;0.6;4288;2848;12212224;1909875;990;1909875;525860;524870;1910865;155
ISIC_0013188;350;4;2;0.01;0.6;3008;2000;6016000;3503959;409;3503959;92544;92135;3504368;411
ISIC_0012547;250;2;3;100.0;0.6;4288;2848;12212224;11494346;0;11494346;572681;572681;11494346;270
ISIC_0007332;300;1;1;1.0;0.6;3024;2016;6096384;5088557;0;5088557;530766;530766;5088557;303
ISIC_0007332;150;3;3;100.0;0.6;3024;2016;6096384;5525218;0;5525218;530766;530766;5525218;165
ISIC_0013082;50;4;1;0.1;0.6;3872;2592;10036224;3453964;10974;3453964;254836;243862;3464938;47
ISIC_0014428;200;1;2;0.01;0.6;4288;2848;12212224;1622554;0;1622554;525860;525860;1622554;186
ISIC_0003657;250;2;2;100.0;0.6;3024;2016;6096384;1824820;296;1824820;340261;339965;1825116;265
ISIC_0013082;100;3;3;0.1;0.6;3872;2592;10036224;3082701;15108;3082701;254836;239728;3097809;102
ISIC_0014712;450;1;1;100.0;0.6;6621;4422;29278062;1065557;17186282;1065557;24292916;7106634;18251839;485
ISIC_0008524;150;2;2;1.0;0.6;4288;2848;12212224;5139207;2654;5139207;323767;321113;5141861;143
ISIC_0013082;50;3;2;1.0;0.6;3872;2592;10036224;3805805;0;3805805;254836;254836;3805805;38
ISIC_0013128;350;4;2;0.1;0.6;3872;2592;10036224;4791183;0;4791183;470897;470897;4791183;412
ISIC_0014428;50;1;3;1.0;0.6;4288;2848;12212224;3159023;1565;3159023;525860;524295;3160588;13
ISIC_0014712;100;1;1;0.1;0.6;6621;4422;29278062;3531788;10897264;3531788;24292916;13395652;14429052;62
ISIC_0014712;250;4;3;100.0;0.6;6621;4422;29278062;1784884;17881902;1784884;24292916;6411014;19666786;300
ISIC_0008524;50;1;1;100.0;0.6;4288;2848;12212224;6157247;12028;6157247;323767;311739;6169275;5
ISIC_0014623;350;2;3;100.0;0.6;2592;1936;5018112;1096117;1040131;1096117;1937167;897036;2136248;390
ISIC_0014712;250;2;3;100.0;0.6;6621;4422;29278062;1784884;16828997;1784884;24292916;7463919;18613881;270
ISIC_0003657;450;2;2;0.01;0.6;3024;2016;6096384;1619292;11281;1619292;340261;328980;1630573;501
ISIC_0014623;200;4;1;0.1;0.6;2592;1936;5018112;1131440;957126;1131440;1937167;980041;2088566;227
ISIC_0003657;400;4;2;100.0;0.6;3024;2016;6096384;1481931;3890;1481931;340261;336371;1485821;475
ISIC_0008524;450;2;3;0.01;0.6;4288;2848;12212224;3911851;2974;3911851;323767;320793;3914825;506
ISIC_0014712;300;1;2;1.0;0.6;6621;4422;29278062;1326292;15821787;1326292;24292916;8471129;17148079;308
ISIC_0008524;450;3;2;0.01;0.6;4288;2848;12212224;3789033;2832;3789033;323767;320935;3791865;516
ISIC_0013082;350;2;2;1.0;0.6;3872;2592;10036224;1953809;0;1953809;254836;254836;1953809;383
ISIC_0003657;450;2;3;0.1;0.6;3024;2016;6096384;1640274;0;1640274;340261;340261;1640274;507
ISIC_0014623;200;2;3;0.01;0.6;2592;1936;5018112;1397977;840444;1397977;1937167;1096723;2238421;206
ISIC_0013082;50;1;2;100.0;0.6;3872;2592;10036224;3808783;0;3808783;254836;254836;3808783;10
ISIC_0014623;350;2;3;10.0;0.6;2592;1936;5018112;1096061;1040131;1096061;1937167;897036;2136192;389
ISIC_0007332;400;4;2;10.0;0.6;3024;2016;6096384;4766918;0;4766918;530766;530766;4766918;474
ISIC_0013082;450;2;2;0.1;0.6;3872;2592;10036224;1548762;1613;1548762;254836;253223;1550375;502
ISIC_0014712;300;4;1;0.1;0.6;6621;4422;29278062;1359750;18770521;1359750;24292916;5522395;20130271;347
ISIC_0014428;300;2;1;0.1;0.6;4288;2848;12212224;1216220;1064;1216220;525860;524796;1217284;317
ISIC_0014623;300;1;1;1.0;0.6;2592;1936;5018112;1211527;958686;1211527;1937167;978481;2170213;303
ISIC_0014623;50;2;2;10.0;0.6;2592;1936;5018112;2054735;437022;2054735;1937167;1500145;2491757;24
ISIC_0013188;350;4;3;100.0;0.6;3008;2000;6016000;3509965;0;3509965;92544;92544;3509965;420
ISIC_0014712;450;4;2;0.1;0.6;6621;4422;29278062;1010530;19339682;1010530;24292916;4953234;20350212;532
ISIC_0014428;100;3;1;1.0;0.6;4288;2848;12212224;2386877;6905;2386877;525860;518955;2393782;93
ISIC_0014712;300;3;2;10.0;0.6;6621;4422;29278062;1314378;17478141;1314378;24292916;6814775;18792519;339
ISIC_0014428;450;2;2;10.0;0.6;4288;2848;12212224;1156198;8163;1156198;525860;517697;1164361;504
ISIC_0007332;450;3;2;100.0;0.6;3024;2016;6096384;4683750;83;4683750;530766;530683;4683833;520
ISIC_0014428;100;1;2;1.0;0.6;4288;2848;12212224;2508454;7987;2508454;525860;517873;2516441;68
ISIC_0014623;450;3;1;100.0;0.6;2592;1936;5018112;954580;1178551;954580;1937167;758616;2133131;515
ISIC_0013082;200;3;1;10.0;0.6;3872;2592;10036224;2123893;200;2123893;254836;254636;2124093;214
ISIC_0013128;150;4;3;100.0;0.6;3872;2592;10036224;5678295;0;5678295;470897;470897;5678295;180
ISIC_0007332;350;4;2;0.01;0.6;3024;2016;6096384;4868538;0;4868538;530766;530766;4868538;411
ISIC_0013188;300;4;1;10.0;0.6;3008;2000;6016000;3655663;45;3655663;92544;92499;3655708;349
ISIC_0013128;100;4;1;100.0;0.6;3872;2592;10036224;6459067;0;6459067;470897;470897;6459067;110
ISIC_0013188;150;4;2;1.0;0.6;3008;2000;6016000;4396392;0;4396392;92544;92544;4396392;173
ISIC_0012547;250;3;3;1.0;0.6;4288;2848;12212224;11493840;0;11493840;572681;572681;11493840;283
ISIC_0013082;200;1;1;0.01;0.6;3872;2592;10036224;2481211;0;2481211;254836;254836;2481211;181
ISIC_0014428;200;2;3;0.01;0.6;4288;2848;12212224;1408376;2969;1408376;525860;522891;1411345;206
ISIC_0012547;200;4;3;10.0;0.6;4288;2848;12212224;11253224;61009;11253224;572681;511672;11314233;239
ISIC_0007332;450;3;1;10.0;0.6;3024;2016;6096384;4683670;83;4683670;530766;530683;4683753;514
ISIC_0003657;400;1;1;1.0;0.6;3024;2016;6096384;1795580;3965;1795580;340261;336296;1799545;423
ISIC_0013082;150;3;1;100.0;0.6;3872;2592;10036224;2759697;183;2759697;254836;254653;2759880;155
ISIC_0014428;100;1;3;0.01;0.6;4288;2848;12212224;2536872;7494;2536872;525860;518366;2544366;71
ISIC_0013128;250;4;3;0.1;0.6;3872;2592;10036224;5314121;0;5314121;470897;470897;5314121;297
ISIC_0013188;50;3;2;1.0;0.6;3008;2000;6016000;5064308;0;5064308;92544;92544;5064308;38
ISIC_0007332;100;2;2;0.01;0.6;3024;2016;6096384;0;530766;0;530766;0;530766;81
ISIC_0013128;350;3;1;10.0;0.6;3872;2592;10036224;4845101;0;4845101;470897;470897;4845101;394
ISIC_0008524;350;4;2;100.0;0.6;4288;2848;12212224;3333251;277;3333251;323767;323490;3333528;415
ISIC_0008524;450;4;1;10.0;0.6;4288;2848;12212224;2777495;18436;2777495;323767;305331;2795931;529
ISIC_0008524;100;2;2;100.0;0.6;4288;2848;12212224;5531663;4774;5531663;323767;318993;5536437;85
ISIC_0013128;250;4;3;10.0;0.6;3872;2592;10036224;5316829;0;5316829;470897;470897;5316829;299
ISIC_0014428;100;1;1;1.0;0.6;4288;2848;12212224;2629919;138;2629919;525860;525722;2630057;63
ISIC_0012547;350;1;1;0.01;0.6;4288;2848;12212224;11432174;0;11432174;572681;572681;11432174;361
ISIC_0014712;450;3;3;0.1;0.6;6621;4422;29278062;1014465;18678825;1014465;24292916;5614091;19693290;522
ISIC_0007332;200;4;2;0.01;0.6;3024;2016;6096384;5190017;0;5190017;530766;530766;5190017;231
ISIC_0013128;200;1;2;0.01;0.6;3872;2592;10036224;5887988;0;5887988;470897;470897;5887988;186
ISIC_0014623;300;3;2;1.0;0.6;2592;1936;5018112;1080859;1094713;1080859;1937167;842454;2175572;338
ISIC_0003657;400;2;3;0.1;0.6;3024;2016;6096384;1622061;0;1622061;340261;340261;1622061;447
ISIC_0013082;250;1;3;10.0;0.6;3872;2592;10036224;2106429;0;2106429;254836;254836;2106429;254
ISIC_0013128;300;3;1;0.01;0.6;3872;2592;10036224;5152017;0;5152017;470897;470897;5152017;331
ISIC_0013128;150;3;2;100.0;0.6;3872;2592;10036224;5745354;0;5745354;470897;470897;5745354;160
ISIC_0014623;400;4;2;0.1;0.6;2592;1936;5018112;977203;1145441;977203;1937167;791726;2122644;472
ISIC_0008524;100;1;2;1.0;0.6;4288;2848;12212224;5764860;1983;5764860;323767;321784;5766843;68
ISIC_0014712;450;3;1;10.0;0.6;6621;4422;29278062;1061987;18360557;1061987;24292916;5932359;19422544;514
ISIC_0013082;100;3;1;10.0;0.6;3872;2592;10036224;2998479;0;2998479;254836;254836;2998479;94
ISIC_0007332;200;3;1;10.0;0.6;3024;2016;6096384;5168488;0;5168488;530766;530766;5168488;214
ISIC_0003657;350;3;3;0.1;0.6;3024;2016;6096384;1693276;0;1693276;340261;340261;1693276;402
ISIC_0013128;250;3;3;100.0;0.6;3872;2592;10036224;5441793;0;5441793;470897;470897;5441793;285
ISIC_0003657;200;4;2;100.0;0.6;3024;2016;6096384;1637358;1959;1637358;340261;338302;1639317;235
ISIC_0003657;100;1;1;0.1;0.6;3024;2016;6096384;2842322;0;2842322;340261;340261;2842322;62
ISIC_0014623;150;3;1;1.0;0.6;2592;1936;5018112;1340995;886733;1340995;1937167;1050434;2227728;153
ISIC_0013082;450;1;1;100.0;0.6;3872;2592;10036224;1722804;1608;1722804;254836;253228;1724412;485
ISIC_0014712;150;2;1;0.01;0.6;6621;4422;29278062;1889933;14186525;1889933;24292916;10106391;16076458;136
ISIC_0007332;450;2;2;100.0;0.6;3024;2016;6096384;4683750;83;4683750;530766;530683;4683833;505
ISIC_0012547;300;4;1;0.01;0.6;4288;2848;12212224;11431959;0;11431959;572681;572681;11431959;346
ISIC_0008524;350;4;2;0.1;0.6;4288;2848;12212224;3361607;138;3361607;323767;323629;3361745;412
ISIC_0014428;150;3;1;1.0;0.6;4288;2848;12212224;1905076;2554;1905076;525860;523306;1907630;153
ISIC_0013128;350;1;1;0.01;0.6;3872;2592;10036224;5061002;0;5061002;470897;470897;5061002;361
ISIC_0008524;350;1;1;0.01;0.6;4288;2848;12212224;4441628;4558;4441628;323767;319209;4446186;361
ISIC_0014428;350;3;3;0.1;0.6;4288;2848;12212224;1022102;283;1022102;525860;525577;1022385;402
ISIC_0007332;350;4;2;10.0;0.6;3024;2016;6096384;4854669;0;4854669;530766;530766;4854669;414
ISIC_0007332;300;4;2;0.01;0.6;3024;2016;6096384;4910616;0;4910616;530766;530766;4910616;351
ISIC_0014623;300;4;2;1.0;0.6;2592;1936;5018112;1030289;1127995;1030289;1937167;809172;2158284;353
ISIC_0007332;400;2;2;100.0;0.6;3024;2016;6096384;4811876;0;4811876;530766;530766;4811876;445
ISIC_0008524;200;4;2;0.1;0.6;4288;2848;12212224;4179436;10479;4179436;323767;313288;4189915;232
ISIC_0014623;300;4;3;0.01;0.6;2592;1936;5018112;969111;1138921;969111;1937167;798246;2108032;356
ISIC_0003657;250;2;3;100.0;0.6;3024;2016;6096384;1824939;296;1824939;340261;339965;1825235;270
ISIC_0007332;300;1;3;1.0;0.6;3024;2016;6096384;5088426;0;5088426;530766;530766;5088426;313
ISIC_0013188;250;4;1;0.01;0.6;3008;2000;6016000;4012854;0;4012854;92544;92544;4012854;286
ISIC_0014428;350;1;3;1.0;0.6;4288;2848;12212224;1296090;1199;1296090;525860;524661;1297289;373
ISIC_0014623;400;4;2;1.0;0.6;2592;1936;5018112;976805;1142970;976805;1937167;794197;2119775;473
ISIC_0003657;400;2;2;10.0;0.6;3024;2016;6096384;1610030;3890;1610030;340261;336371;1613920;444
ISIC_0013188;250;2;3;0.1;0.6;3008;2000;6016000;3798527;0;3798527;92544;92544;3798527;267
ISIC_0007332;200;2;1;0.01;0.6;3024;2016;6096384;5307747;0;5307747;530766;530766;5307747;196
ISIC_0013082;400;4;3;10.0;0.6;3872;2592;10036224;1834362;0;1834362;254836;254836;1834362;479
ISIC_0014428;100;1;1;10.0;0.6;4288;2848;12212224;2634495;536;2634495;525860;525324;2635031;64
ISIC_0013128;200;3;2;0.01;0.6;3872;2592;10036224;5792283;0;5792283;470897;470897;5792283;216
ISIC_0013188;400;4;1;100.0;0.6;3008;2000;6016000;3250017;0;3250017;92544;92544;3250017;470
ISIC_0003657;100;4;2;100.0;0.6;3024;2016;6096384;2309979;30;2309979;340261;340231;2310009;115
ISIC_0012547;50;3;2;1.0;0.6;4288;2848;12212224;10797672;0;10797672;572681;572681;10797672;38
ISIC_0013128;400;1;1;1.0;0.6;3872;2592;10036224;4736344;0;4736344;470897;470897;4736344;423
ISIC_0014712;150;3;2;10.0;0.6;6621;4422;29278062;1997847;15360548;1997847;24292916;8932368;17358395;159
ISIC_0013128;400;1;3;1.0;0.6;3872;2592;10036224;4736400;0;4736400;470897;470897;4736400;433
ISIC_0014712;200;4;3;1.0;0.6;6621;4422;29278062;1355126;17599595;1355126;24292916;6693321;18954721;238
ISIC_0013188;100;2;3;10.0;0.6;3008;2000;6016000;4801195;0;4801195;92544;92544;4801195;89
ISIC_0013188;50;4;3;0.1;0.6;3008;2000;6016000;5402823;0;5402823;92544;92544;5402823;57
ISIC_0014623;400;4;2;10.0;0.6;2592;1936;5018112;976474;1143080;976474;1937167;794087;2119554;474
ISIC_0013128;150;2;3;0.01;0.6;3872;2592;10036224;5886917;0;5886917;470897;470897;5886917;146
ISIC_0014712;150;3;3;100.0;0.6;6621;4422;29278062;1997847;15360548;1997847;24292916;8932368;17358395;165
ISIC_0012547;450;4;3;0.1;0.6;4288;2848;12212224;11154117;116220;11154117;572681;456461;11270337;537
ISIC_0012547;250;2;3;1.0;0.6;4288;2848;12212224;11493863;0;11493863;572681;572681;11493863;268
ISIC_0003657;50;1;1;1.0;0.6;3024;2016;6096384;2982914;33;2982914;340261;340228;2982947;3
ISIC_0008524;150;2;3;100.0;0.6;4288;2848;12212224;4993804;5649;4993804;323767;318118;4999453;150
ISIC_0014712;150;2;3;0.01;0.6;6621;4422;29278062;1880055;14354232;1880055;24292916;9938684;16234287;146
ISIC_0007332;450;4;1;1.0;0.6;3024;2016;6096384;4640791;83;4640791;530766;530683;4640874;528
ISIC_0007332;50;3;2;10.0;0.6;3024;2016;6096384;5139575;0;5139575;530766;530766;5139575;39
ISIC_0012547;100;3;3;10.0;0.6;4288;2848;12212224;0;572681;0;572681;0;572681;104
ISIC_0013188;400;3;3;0.1;0.6;3008;2000;6016000;3135003;0;3135003;92544;92544;3135003;462
ISIC_0013188;450;2;2;1.0;0.6;3008;2000;6016000;3152483;359;3152483;92544;92185;3152842;503
ISIC_0013128;450;1;1;100.0;0.6;3872;2592;10036224;4786516;0;4786516;470897;470897;4786516;485
ISIC_0013082;300;4;3;0.1;0.6;3872;2592;10036224;1989224;7393;1989224;254836;247443;1996617;357
ISIC_0007332;200;2;2;10.0;0.6;3024;2016;6096384;5168994;0;5168994;530766;530766;5168994;204
ISIC_0007332;200;4;2;100.0;0.6;3024;2016;6096384;5168918;0;5168918;530766;530766;5168918;235
ISIC_0012547;150;1;3;0.1;0.6;4288;2848;12212224;11461079;0;11461079;572681;572681;11461079;132
ISIC_0013082;200;3;2;1.0;0.6;3872;2592;10036224;2130528;527;2130528;254836;254309;2131055;218
ISIC_0013082;350;2;3;0.1;0.6;3872;2592;10036224;1684947;0;1684947;254836;254836;1684947;387
ISIC_0007332;350;2;1;0.1;0.6;3024;2016;6096384;4760513;76;4760513;530766;530690;4760589;377
ISIC_0003657;400;3;1;10.0;0.6;3024;2016;6096384;1539116;3890;1539116;340261;336371;1543006;454
ISIC_0014428;350;2;2;0.1;0.6;4288;2848;12212224;1098601;0;1098601;525860;525860;1098601;382
ISIC_0014623;400;2;1;0.01;0.6;2592;1936;5018112;1075023;1063999;1075023;1937167;873168;2139022;436
ISIC_0014712;400;2;1;100.0;0.6;6621;4422;29278062;1315899;17586458;1315899;24292916;6706458;18902357;440
ISIC_0014623;350;4;2;1.0;0.6;2592;1936;5018112;960385;1143896;960385;1937167;793271;2104281;413
ISIC_0013128;150;3;3;0.01;0.6;3872;2592;10036224;5993414;0;5993414;470897;470897;5993414;161
ISIC_0014623;50;2;1;100.0;0.6;2592;1936;5018112;2054368;437009;2054368;1937167;1500158;2491377;20
ISIC_0014428;450;1;1;10.0;0.6;4288;2848;12212224;1237543;8163;1237543;525860;517697;1245706;484
ISIC_0012547;350;1;3;1.0;0.6;4288;2848;12212224;11289370;36400;11289370;572681;536281;11325770;373
ISIC_0012547;50;1;1;10.0;0.6;4288;2848;12212224;10812075;0;10812075;572681;572681;10812075;4
ISIC_0008524;250;4;2;10.0;0.6;4288;2848;12212224;3692084;7441;3692084;323767;316326;3699525;294
ISIC_0014623;450;2;2;0.01;0.6;2592;1936;5018112;952865;1106737;952865;1937167;830430;2059602;501
ISIC_0014712;450;1;2;100.0;0.6;6621;4422;29278062;1065551;17186282;1065551;24292916;7106634;18251833;490
ISIC_0008524;300;4;1;10.0;0.6;4288;2848;12212224;3661635;4070;3661635;323767;319697;3665705;349
ISIC_0014712;250;2;3;0.01;0.6;6621;4422;29278062;1443902;16968433;1443902;24292916;7324483;18412335;266
ISIC_0014428;150;3;3;10.0;0.6;4288;2848;12212224;1909875;990;1909875;525860;524870;1910865;164
ISIC_0014623;50;4;2;10.0;0.6;2592;1936;5018112;2054474;436762;2054474;1937167;1500405;2491236;54
ISIC_0013188;350;1;2;0.1;0.6;3008;2000;6016000;3445429;0;3445429;92544;92544;3445429;367
ISIC_0014428;450;4;2;0.01;0.6;4288;2848;12212224;829852;7041;829852;525860;518819;836893;531
ISIC_0013128;300;1;1;0.01;0.6;3872;2592;10036224;5236924;0;5236924;470897;470897;5236924;301
ISIC_0003657;250;1;3;0.1;0.6;3024;2016;6096384;2061745;628;2061745;340261;339633;2062373;252
ISIC_0003657;50;1;2;100.0;0.6;3024;2016;6096384;2884232;72;2884232;340261;340189;2884304;10
ISIC_0014712;400;2;2;10.0;0.6;6621;4422;29278062;1315899;17585909;1315899;24292916;6707007;18901808;444
ISIC_0014428;50;4;3;1.0;0.6;4288;2848;12212224;3159346;1715;3159346;525860;524145;3161061;58
ISIC_0012547;450;4;1;1.0;0.6;4288;2848;12212224;11089362;108855;11089362;572681;463826;11198217;528
ISIC_0014623;400;1;1;0.1;0.6;2592;1936;5018112;1173129;988149;1173129;1937167;949018;2161278;422
ISIC_0012547;50;1;2;0.01;0.6;4288;2848;12212224;0;572681;0;572681;0;572681;6
ISIC_0013188;150;3;3;10.0;0.6;3008;2000;6016000;4477530;0;4477530;92544;92544;4477530;164
ISIC_0014623;250;4;3;10.0;0.6;2592;1936;5018112;1086075;1047005;1086075;1937167;890162;2133080;299
ISIC_0014712;250;3;3;10.0;0.6;6621;4422;29278062;1784884;17066003;1784884;24292916;7226913;18850887;284
ISIC_0003657;150;2;2;0.1;0.6;3024;2016;6096384;2296197;0;2296197;340261;340261;2296197;142
ISIC_0012547;100;3;3;0.1;0.6;4288;2848;12212224;0;572681;0;572681;0;572681;102
ISIC_0013188;250;3;3;0.1;0.6;3008;2000;6016000;3797762;0;3797762;92544;92544;3797762;282
ISIC_0013188;300;1;2;1.0;0.6;3008;2000;6016000;3675152;42;3675152;92544;92502;3675194;308
ISIC_0013082;200;3;1;0.01;0.6;3872;2592;10036224;2493240;975;2493240;254836;253861;2494215;211
ISIC_0013188;150;3;2;0.01;0.6;3008;2000;6016000;4582720;0;4582720;92544;92544;4582720;156
ISIC_0013128;200;4;1;0.1;0.6;3872;2592;10036224;5564879;0;5564879;470897;470897;5564879;227
ISIC_0007332;400;1;1;100.0;0.6;3024;2016;6096384;4811876;0;4811876;530766;530766;4811876;425
ISIC_0013128;300;4;2;0.01;0.6;3872;2592;10036224;5110470;0;5110470;470897;470897;5110470;351
ISIC_0014623;150;3;1;100.0;0.6;2592;1936;5018112;1340802;887073;1340802;1937167;1050094;2227875;155
ISIC_0007332;450;2;1;100.0;0.6;3024;2016;6096384;4683670;83;4683670;530766;530683;4683753;500
ISIC_0014428;300;3;2;0.1;0.6;4288;2848;12212224;1179278;810;1179278;525860;525050;1180088;337
ISIC_0003657;300;1;1;0.1;0.6;3024;2016;6096384;1954071;0;1954071;340261;340261;1954071;302
ISIC_0014623;450;4;2;1.0;0.6;2592;1936;5018112;875682;1217442;875682;1937167;719725;2093124;533
ISIC_0003657;350;1;3;1.0;0.6;3024;2016;6096384;1805321;2927;1805321;340261;337334;1808248;373
ISIC_0008524;300;1;1;0.1;0.6;4288;2848;12212224;4352148;10377;4352148;323767;313390;4362525;302
ISIC_0013082;200;4;2;100.0;0.6;3872;2592;10036224;2123931;200;2123931;254836;254636;2124131;235
ISIC_0012547;50;4;3;0.1;0.6;4288;2848;12212224;0;572681;0;572681;0;572681;57
ISIC_0014428;150;4;2;0.01;0.6;4288;2848;12212224;1780712;0;1780712;525860;525860;1780712;171
ISIC_0014428;300;2;3;100.0;0.6;4288;2848;12212224;1252282;1843;1252282;525860;524017;1254125;330
ISIC_0007332;50;1;2;1.0;0.6;3024;2016;6096384;5117376;0;5117376;530766;530766;5117376;8
ISIC_0013128;450;4;2;10.0;0.6;3872;2592;10036224;4438035;0;4438035;470897;470897;4438035;534
ISIC_0014712;250;1;2;0.01;0.6;6621;4422;29278062;2052076;15863389;2052076;24292916;8429527;17915465;246
ISIC_0007332;300;2;2;0.01;0.6;3024;2016;6096384;4976315;0;4976315;530766;530766;4976315;321
ISIC_0014623;100;4;3;0.1;0.6;2592;1936;5018112;1661261;700555;1661261;1937167;1236612;2361816;117
ISIC_0014712;300;1;1;1.0;0.6;6621;4422;29278062;1326288;15821784;1326288;24292916;8471132;17148072;303
ISIC_0013188;350;3;1;1.0;0.6;3008;2000;6016000;3507809;0;3507809;92544;92544;3507809;393
ISIC_0008524;250;3;2;0.01;0.6;4288;2848;12212224;4634216;0;4634216;323767;323767;4634216;276
ISIC_0012547;450;4;1;100.0;0.6;4288;2848;12212224;11029056;108900;11029056;572681;463781;11137956;530
ISIC_0012547;200;3;3;1.0;0.6;4288;2848;12212224;11262925;0;11262925;572681;572681;11262925;223
ISIC_0013082;50;2;2;1.0;0.6;3872;2592;10036224;3805853;0;3805853;254836;254836;3805853;23
ISIC_0007332;100;1;2;0.1;0.6;3024;2016;6096384;0;530766;0;530766;0;530766;67
ISIC_0013128;400;3;2;10.0;0.6;3872;2592;10036224;4609415;0;4609415;470897;470897;4609415;459
ISIC_0013082;450;4;3;0.01;0.6;3872;2592;10036224;1420717;16334;1420717;254836;238502;1437051;536
ISIC_0012547;450;4;3;0.01;0.6;4288;2848;12212224;11362144;135226;11362144;572681;437455;11497370;536
ISIC_0013082;300;1;1;100.0;0.6;3872;2592;10036224;2200671;224;2200671;254836;254612;2200895;305
ISIC_0008524;100;2;2;0.01;0.6;4288;2848;12212224;6042359;2757;6042359;323767;321010;6045116;81
ISIC_0014428;200;1;1;0.01;0.6;4288;2848;12212224;1810072;0;1810072;525860;525860;1810072;181
ISIC_0014712;200;4;1;1.0;0.6;6621;4422;29278062;1354970;17599435;1354970;24292916;6693481;18954405;228
ISIC_0013128;450;1;2;100.0;0.6;3872;2592;10036224;4786516;0;4786516;470897;470897;4786516;490
ISIC_0007332;300;2;1;100.0;0.6;3024;2016;6096384;5109013;0;5109013;530766;530766;5109013;320
ISIC_0014712;50;2;2;10.0;0.6;6621;4422;29278062;2464654;12862508;2464654;24292916;11430408;15327162;24
ISIC_0013082;400;2;1;0.1;0.6;3872;2592;10036224;1483828;0;1483828;254836;254836;1483828;437
ISIC_0007332;450;2;3;1.0;0.6;3024;2016;6096384;4683785;83;4683785;530766;530683;4683868;508
ISIC_0014428;150;1;3;0.1;0.6;4288;2848;12212224;1918100;0;1918100;525860;525860;1918100;132
ISIC_0013188;450;1;3;0.1;0.6;3008;2000;6016000;3102848;0;3102848;92544;92544;3102848;492
ISIC_0014712;250;1;3;10.0;0.6;6621;4422;29278062;2006505;15387117;2006505;24292916;8905799;17393622;254
ISIC_0014623;300;2;3;0.1;0.6;2592;1936;5018112;1107296;1044727;1107296;1937167;892440;2152023;327
ISIC_0013082;50;3;1;0.1;0.6;3872;2592;10036224;3454418;10958;3454418;254836;243878;3465376;32
ISIC_0007332;400;3;3;10.0;0.6;3024;2016;6096384;4811754;0;4811754;530766;530766;4811754;464
ISIC_0012547;350;1;1;1.0;0.6;4288;2848;12212224;11289404;36400;11289404;572681;536281;11325804;363
ISIC_0003657;200;2;2;0.01;0.6;3024;2016;6096384;2070590;13405;2070590;340261;326856;2083995;201
ISIC_0014428;100;3;1;0.1;0.6;4288;2848;12212224;1918322;14585;1918322;525860;511275;1932907;92
ISIC_0014428;400;1;1;1.0;0.6;4288;2848;12212224;1131765;4524;1131765;525860;521336;1136289;423
ISIC_0007332;350;4;3;1.0;0.6;3024;2016;6096384;4854540;0;4854540;530766;530766;4854540;418
ISIC_0013082;450;4;2;0.1;0.6;3872;2592;10036224;1573208;1594;1573208;254836;253242;1574802;532
ISIC_0013188;100;4;1;0.1;0.6;3008;2000;6016000;4924967;0;4924967;92544;92544;4924967;107
ISIC_0007332;100;4;2;1.0;0.6;3024;2016;6096384;0;530766;0;530766;0;530766;113
ISIC_0014623;50;4;1;10.0;0.6;2592;1936;5018112;2054518;436911;2054518;1937167;1500256;2491429;49
ISIC_0013128;50;1;1;100.0;0.6;3872;2592;10036224;6970975;0;6970975;470897;470897;6970975;5
ISIC_0014623;400;1;3;0.01;0.6;2592;1936;5018112;1083036;970327;1083036;1937167;966840;2053363;431
ISIC_0014428;50;1;1;100.0;0.6;4288;2848;12212224;2715664;1211;2715664;525860;524649;2716875;5
ISIC_0013082;450;3;3;0.01;0.6;3872;2592;10036224;1434054;9900;1434054;254836;244936;1443954;521
ISIC_0007332;300;2;1;1.0;0.6;3024;2016;6096384;5088412;0;5088412;530766;530766;5088412;318
ISIC_0014623;150;2;1;100.0;0.6;2592;1936;5018112;1540386;753664;1540386;1937167;1183503;2294050;140
ISIC_0013128;350;2;2;100.0;0.6;3872;2592;10036224;4996086;0;4996086;470897;470897;4996086;385
ISIC_0014428;100;1;1;0.01;0.6;4288;2848;12212224;3153865;0;3153865;525860;525860;3153865;61
ISIC_0012547;400;4;3;10.0;0.6;4288;2848;12212224;11164555;122500;11164555;572681;450181;11287055;479
ISIC_0014712;50;1;2;0.1;0.6;6621;4422;29278062;2820922;10434302;2820922;24292916;13858614;13255224;7
ISIC_0007332;100;2;3;1.0;0.6;3024;2016;6096384;0;530766;0;530766;0;530766;88
ISIC_0008524;350;1;2;1.0;0.6;4288;2848;12212224;4209171;3059;4209171;323767;320708;4212230;368
ISIC_0013082;200;2;1;0.1;0.6;3872;2592;10036224;2079229;9900;2079229;254836;244936;2089129;197
ISIC_0007332;100;3;2;0.1;0.6;3024;2016;6096384;0;530766;0;530766;0;530766;97
ISIC_0014712;250;4;3;10.0;0.6;6621;4422;29278062;1784884;17881902;1784884;24292916;6411014;19666786;299
ISIC_0013082;350;2;2;100.0;0.6;3872;2592;10036224;1955510;0;1955510;254836;254836;1955510;385
ISIC_0003657;400;4;3;100.0;0.6;3024;2016;6096384;1481954;3890;1481954;340261;336371;1485844;480
ISIC_0014623;200;2;1;10.0;0.6;2592;1936;5018112;1310960;843827;1310960;1937167;1093340;2154787;199
ISIC_0008524;450;4;2;0.1;0.6;4288;2848;12212224;2847223;9407;2847223;323767;314360;2856630;532
ISIC_0012547;450;4;2;0.01;0.6;4288;2848;12212224;11357588;102024;11357588;572681;470657;11459612;531
ISIC_0013082;450;4;2;0.01;0.6;3872;2592;10036224;1605130;9026;1605130;254836;245810;1614156;531
ISIC_0013082;50;4;1;0.01;0.6;3872;2592;10036224;3870714;0;3870714;254836;254836;3870714;46
ISIC_0014428;450;2;3;0.01;0.6;4288;2848;12212224;722220;7569;722220;525860;518291;729789;506
ISIC_0014712;50;2;2;0.1;0.6;6621;4422;29278062;2457922;13468634;2457922;24292916;10824282;15926556;22
ISIC_0007332;250;3;2;0.01;0.6;3024;2016;6096384;5063672;0;5063672;530766;530766;5063672;276
ISIC_0007332;100;4;1;0.01;0.6;3024;2016;6096384;0;530766;0;530766;0;530766;106
ISIC_0013188;450;3;3;1.0;0.6;3008;2000;6016000;3152405;351;3152405;92544;92193;3152756;523
ISIC_0003657;50;2;3;0.01;0.6;3024;2016;6096384;3156619;11702;3156619;340261;328559;3168321;26
ISIC_0013128;100;3;2;1.0;0.6;3872;2592;10036224;6559599;0;6559599;470897;470897;6559599;98
ISIC_0013128;350;3;2;100.0;0.6;3872;2592;10036224;4845094;0;4845094;470897;470897;4845094;400
ISIC_0014712;100;2;3;0.1;0.6;6621;4422;29278062;3200283;12341107;3200283;24292916;11951809;15541390;87
ISIC_0014428;400;2;1;10.0;0.6;4288;2848;12212224;1140493;2798;1140493;525860;523062;1143291;439
ISIC_0012547;350;4;2;0.01;0.6;4288;2848;12212224;11322749;141948;11322749;572681;430733;11464697;411
ISIC_0013188;100;3;2;0.01;0.6;3008;2000;6016000;4931741;0;4931741;92544;92544;4931741;96
ISIC_0014623;100;4;2;100.0;0.6;2592;1936;5018112;1496042;767922;1496042;1937167;1169245;2263964;115
ISIC_0008524;300;3;3;10.0;0.6;4288;2848;12212224;4263862;4070;4263862;323767;319697;4267932;344
ISIC_0014428;150;3;2;10.0;0.6;4288;2848;12212224;1909875;990;1909875;525860;524870;1910865;159
ISIC_0012547;450;2;1;10.0;0.6;4288;2848;12212224;11254268;54450;11254268;572681;518231;11308718;499
ISIC_0012547;200;4;2;100.0;0.6;4288;2848;12212224;11252530;61009;11252530;572681;511672;11313539;235
ISIC_0013128;200;1;2;0.1;0.6;3872;2592;10036224;5802997;0;5802997;470897;470897;5802997;187
ISIC_0014428;200;1;3;100.0;0.6;4288;2848;12212224;1568875;999;1568875;525860;524861;1569874;195
ISIC_0003657;450;1;1;0.1;0.6;3024;2016;6096384;1772300;0;1772300;340261;340261;1772300;482
ISIC_0003657;350;1;1;0.1;0.6;3024;2016;6096384;1870697;0;1870697;340261;340261;1870697;362
ISIC_0012547;350;3;1;0.01;0.6;4288;2848;12212224;11423785;84441;11423785;572681;488240;11508226;391
ISIC_0008524;100;3;3;10.0;0.6;4288;2848;12212224;5531426;4776;5531426;323767;318991;5536202;104
ISIC_0013188;250;1;3;0.1;0.6;3008;2000;6016000;3745919;0;3745919;92544;92544;3745919;252
ISIC_0013082;100;1;2;1.0;0.6;3872;2592;10036224;3104587;0;3104587;254836;254836;3104587;68
ISIC_0014712;400;2;1;0.1;0.6;6621;4422;29278062;1281866;17676555;1281866;24292916;6616361;18958421;437
ISIC_0014712;400;2;2;0.1;0.6;6621;4422;29278062;1284611;17669132;1284611;24292916;6623784;18953743;442
ISIC_0007332;400;4;1;0.01;0.6;3024;2016;6096384;4810554;3904;4810554;530766;526862;4814458;466
ISIC_0013188;50;1;3;0.01;0.6;3008;2000;6016000;5526792;0;5526792;92544;92544;5526792;11
ISIC_0008524;150;4;3;100.0;0.6;4288;2848;12212224;4173003;5649;4173003;323767;318118;4178652;180
ISIC_0014623;400;2;3;0.01;0.6;2592;1936;5018112;1077651;1058497;1077651;1937167;878670;2136148;446
ISIC_0013128;450;2;3;1.0;0.6;3872;2592;10036224;4668819;0;4668819;470897;470897;4668819;508
ISIC_0013128;200;2;1;100.0;0.6;3872;2592;10036224;5661375;0;5661375;470897;470897;5661375;200
ISIC_0012547;350;1;3;10.0;0.6;4288;2848;12212224;11289047;36400;11289047;572681;536281;11325447;374
ISIC_0003657;50;2;2;1.0;0.6;3024;2016;6096384;2634407;53;2634407;340261;340208;2634460;23
ISIC_0014712;450;4;3;1.0;0.6;6621;4422;29278062;1058207;19009610;1058207;24292916;5283306;20067817;538
ISIC_0012547;400;1;3;10.0;0.6;4288;2848;12212224;11250166;0;11250166;572681;572681;11250166;434
ISIC_0012547;400;1;2;10.0;0.6;4288;2848;12212224;11250166;0;11250166;572681;572681;11250166;429
ISIC_0003657;400;1;1;0.01;0.6;3024;2016;6096384;1877846;119;1877846;340261;340142;1877965;421
ISIC_0013128;150;2;2;100.0;0.6;3872;2592;10036224;5812694;0;5812694;470897;470897;5812694;145
ISIC_0014712;100;4;1;1.0;0.6;6621;4422;29278062;3327064;14541970;3327064;24292916;9750946;17869034;108
ISIC_0014623;50;2;3;0.1;0.6;2592;1936;5018112;2045510;448620;2045510;1937167;1488547;2494130;27
ISIC_0013188;450;3;2;1.0;0.6;3008;2000;6016000;3152328;353;3152328;92544;92191;3152681;518
ISIC_0014712;150;3;2;1.0;0.6;6621;4422;29278062;1999260;15360638;1999260;24292916;8932278;17359898;158
ISIC_0012547;400;4;1;10.0;0.6;4288;2848;12212224;11164548;122500;11164548;572681;450181;11287048;469
ISIC_0014428;100;1;1;0.1;0.6;4288;2848;12212224;2424769;0;2424769;525860;525860;2424769;62
ISIC_0008524;50;1;2;1.0;0.6;4288;2848;12212224;6140193;13368;6140193;323767;310399;6153561;8
ISIC_0014712;100;4;1;10.0;0.6;6621;4422;29278062;3327035;14542540;3327035;24292916;9750376;17869575;109
ISIC_0012547;50;2;2;0.01;0.6;4288;2848;12212224;0;572681;0;572681;0;572681;21
ISIC_0013128;450;2;1;0.1;0.6;3872;2592;10036224;4650199;0;4650199;470897;470897;4650199;497
ISIC_0007332;350;3;3;0.01;0.6;3024;2016;6096384;4658952;0;4658952;530766;530766;4658952;401
ISIC_0013082;350;2;3;1.0;0.6;3872;2592;10036224;1953528;0;1953528;254836;254836;1953528;388
ISIC_0008524;150;4;2;0.1;0.6;4288;2848;12212224;4492373;0;4492373;323767;323767;4492373;172
ISIC_0013188;450;4;2;10.0;0.6;3008;2000;6016000;3126131;0;3126131;92544;92544;3126131;534
ISIC_0007332;250;3;3;10.0;0.6;3024;2016;6096384;5150273;895;5150273;530766;529871;5151168;284
ISIC_0012547;300;3;3;0.1;0.6;4288;2848;12212224;11380947;48144;11380947;572681;524537;11429091;342
ISIC_0013082;350;3;3;10.0;0.6;3872;2592;10036224;1955525;0;1955525;254836;254836;1955525;404
ISIC_0014712;150;4;2;1.0;0.6;6621;4422;29278062;1800792;16333470;1800792;24292916;7959446;18134262;173
ISIC_0008524;150;1;2;100.0;0.6;4288;2848;12212224;4994089;5649;4994089;323767;318118;4999738;130
ISIC_0013082;250;1;2;100.0;0.6;3872;2592;10036224;2106430;0;2106430;254836;254836;2106430;250
ISIC_0013082;250;2;3;1.0;0.6;3872;2592;10036224;2106278;0;2106278;254836;254836;2106278;268
ISIC_0014623;50;1;2;1.0;0.6;2592;1936;5018112;2352776;422722;2352776;1937167;1514445;2775498;8
ISIC_0008524;50;3;1;1.0;0.6;4288;2848;12212224;6142801;14126;6142801;323767;309641;6156927;33
ISIC_0014623;200;2;2;0.01;0.6;2592;1936;5018112;1360307;873920;1360307;1937167;1063247;2234227;201
ISIC_0013188;300;3;2;10.0;0.6;3008;2000;6016000;3696079;45;3696079;92544;92499;3696124;339
ISIC_0013082;200;4;3;1.0;0.6;3872;2592;10036224;2131308;571;2131308;254836;254265;2131879;238
ISIC_0012547;400;2;3;0.1;0.6;4288;2848;12212224;11294130;0;11294130;572681;572681;11294130;447
ISIC_0014623;50;3;2;0.1;0.6;2592;1936;5018112;2048550;442478;2048550;1937167;1494689;2491028;37
ISIC_0013128;400;1;1;0.1;0.6;3872;2592;10036224;4755074;0;4755074;470897;470897;4755074;422
ISIC_0007332;350;4;2;0.1;0.6;3024;2016;6096384;4764831;713;4764831;530766;530053;4765544;412
ISIC_0014623;350;4;1;100.0;0.6;2592;1936;5018112;960195;1143971;960195;1937167;793196;2104166;410
ISIC_0003657;300;3;1;100.0;0.6;3024;2016;6096384;1603022;2337;1603022;340261;337924;1605359;335
ISIC_0014428;300;1;1;10.0;0.6;4288;2848;12212224;1337724;1843;1337724;525860;524017;1339567;304
ISIC_0014712;350;1;3;1.0;0.6;6621;4422;29278062;1260462;15587962;1260462;24292916;8704954;16848424;373
ISIC_0014428;300;4;1;0.1;0.6;4288;2848;12212224;1084156;1136;1084156;525860;524724;1085292;347
ISIC_0012547;200;2;2;0.1;0.6;4288;2848;12212224;11513048;0;11513048;572681;572681;11513048;202
ISIC_0014428;350;3;1;0.01;0.6;4288;2848;12212224;1224085;29;1224085;525860;525831;1224114;391
ISIC_0008524;400;3;1;0.01;0.6;4288;2848;12212224;3887905;1400;3887905;323767;322367;3889305;451
ISIC_0014623;100;4;3;1.0;0.6;2592;1936;5018112;1492772;768357;1492772;1937167;1168810;2261129;118
ISIC_0014712;50;4;2;100.0;0.6;6621;4422;29278062;2259575;13772367;2259575;24292916;10520549;16031942;55
ISIC_0003657;450;3;1;100.0;0.6;3024;2016;6096384;1411920;1807;1411920;340261;338454;1413727;515
ISIC_0008524;200;2;2;0.1;0.6;4288;2848;12212224;4901701;3179;4901701;323767;320588;4904880;202
ISIC_0014623;350;1;2;0.01;0.6;2592;1936;5018112;1173022;960047;1173022;1937167;977120;2133069;366
ISIC_0007332;50;1;1;10.0;0.6;3024;2016;6096384;5142906;0;5142906;530766;530766;5142906;4
ISIC_0013082;450;3;1;0.01;0.6;3872;2592;10036224;1699478;0;1699478;254836;254836;1699478;511
ISIC_0008524;350;2;1;0.01;0.6;4288;2848;12212224;4185346;4178;4185346;323767;319589;4189524;376
ISIC_0014712;100;1;1;100.0;0.6;6621;4422;29278062;3652299;10960585;3652299;24292916;13332331;14612884;65
ISIC_0014428;200;3;3;1.0;0.6;4288;2848;12212224;1398821;2422;1398821;525860;523438;1401243;223
ISIC_0013188;400;4;3;100.0;0.6;3008;2000;6016000;3250018;0;3250018;92544;92544;3250018;480
ISIC_0008524;200;4;2;0.01;0.6;4288;2848;12212224;4221903;0;4221903;323767;323767;4221903;231
ISIC_0003657;200;1;2;0.1;0.6;3024;2016;6096384;2273944;0;2273944;340261;340261;2273944;187
ISIC_0014428;400;1;2;0.01;0.6;4288;2848;12212224;1119447;6143;1119447;525860;519717;1125590;426
ISIC_0008524;250;4;2;1.0;0.6;4288;2848;12212224;3692246;9328;3692246;323767;314439;3701574;293
ISIC_0013128;200;2;2;0.1;0.6;3872;2592;10036224;5660291;0;5660291;470897;470897;5660291;202
ISIC_0012547;450;1;3;10.0;0.6;4288;2848;12212224;11281493;0;11281493;572681;572681;11281493;494
ISIC_0013082;250;1;3;100.0;0.6;3872;2592;10036224;2106430;0;2106430;254836;254836;2106430;255
ISIC_0014428;50;2;3;10.0;0.6;4288;2848;12212224;2715585;1211;2715585;525860;524649;2716796;29
ISIC_0007332;400;4;3;1.0;0.6;3024;2016;6096384;4767076;0;4767076;530766;530766;4767076;478
ISIC_0013082;200;3;1;100.0;0.6;3872;2592;10036224;2123932;200;2123932;254836;254636;2124132;215
ISIC_0008524;400;1;2;0.1;0.6;4288;2848;12212224;4078995;3578;4078995;323767;320189;4082573;427
ISIC_0012547;300;3;2;10.0;0.6;4288;2848;12212224;11305031;81608;11305031;572681;491073;11386639;339
ISIC_0014712;150;4;3;10.0;0.6;6621;4422;29278062;1799378;16333380;1799378;24292916;7959536;18132758;179
ISIC_0013188;50;2;1;0.01;0.6;3008;2000;6016000;5529307;0;5529307;92544;92544;5529307;16
ISIC_0014428;300;1;2;10.0;0.6;4288;2848;12212224;1337726;1843;1337726;525860;524017;1339569;309
ISIC_0013128;450;2;1;100.0;0.6;3872;2592;10036224;4668657;0;4668657;470897;470897;4668657;500
ISIC_0014712;300;2;2;100.0;0.6;6621;4422;29278062;1318803;17086948;1318803;24292916;7205968;18405751;325
ISIC_0008524;250;4;1;0.01;0.6;4288;2848;12212224;4055619;0;4055619;323767;323767;4055619;286
ISIC_0008524;350;3;3;10.0;0.6;4288;2848;12212224;4100594;277;4100594;323767;323490;4100871;404
ISIC_0014623;350;4;3;100.0;0.6;2592;1936;5018112;960262;1144291;960262;1937167;792876;2104553;420
ISIC_0014623;250;4;1;10.0;0.6;2592;1936;5018112;1086077;1047196;1086077;1937167;889971;2133273;289
ISIC_0014428;250;2;2;1.0;0.6;4288;2848;12212224;1411015;0;1411015;525860;525860;1411015;263
ISIC_0014623;100;2;1;0.1;0.6;2592;1936;5018112;1680708;550209;1680708;1937167;1386958;2230917;77
ISIC_0014623;50;4;3;1.0;0.6;2592;1936;5018112;2054491;437128;2054491;1937167;1500039;2491619;58
ISIC_0008524;300;3;1;1.0;0.6;4288;2848;12212224;4306715;1267;4306715;323767;322500;4307982;333
ISIC_0003657;250;3;2;0.1;0.6;3024;2016;6096384;1779918;523;1779918;340261;339738;1780441;277
ISIC_0012547;450;1;3;0.1;0.6;4288;2848;12212224;11258225;29674;11258225;572681;543007;11287899;492
ISIC_0014712;250;3;2;0.01;0.6;6621;4422;29278062;1808399;17318698;1808399;24292916;6974218;19127097;276
ISIC_0013082;300;4;2;0.01;0.6;3872;2592;10036224;1928171;2423;1928171;254836;252413;1930594;351
ISIC_0014623;150;2;2;100.0;0.6;2592;1936;5018112;1540473;753627;1540473;1937167;1183540;2294100;145
ISIC_0013188;150;2;3;100.0;0.6;3008;2000;6016000;4477530;0;4477530;92544;92544;4477530;150
ISIC_0014428;350;2;1;1.0;0.6;4288;2848;12212224;1161562;8950;1161562;525860;516910;1170512;378
ISIC_0013082;150;1;1;1.0;0.6;3872;2592;10036224;2690862;1578;2690862;254836;253258;2692440;123
ISIC_0013082;50;4;1;10.0;0.6;3872;2592;10036224;3809084;0;3809084;254836;254836;3809084;49
ISIC_0012547;50;3;1;100.0;0.6;4288;2848;12212224;10811912;0;10811912;572681;572681;10811912;35
ISIC_0014712;450;2;2;0.1;0.6;6621;4422;29278062;946366;18405432;946366;24292916;5887484;19351798;502
ISIC_0003657;350;2;1;0.1;0.6;3024;2016;6096384;1732578;0;1732578;340261;340261;1732578;377
ISIC_0013082;350;3;2;0.01;0.6;3872;2592;10036224;1712585;3962;1712585;254836;250874;1716547;396
ISIC_0013082;100;2;2;0.01;0.6;3872;2592;10036224;3094788;17535;3094788;254836;237301;3112323;81
ISIC_0003657;300;1;3;0.01;0.6;3024;2016;6096384;1990702;13709;1990702;340261;326552;2004411;311
ISIC_0014428;450;3;3;1.0;0.6;4288;2848;12212224;1148375;1469;1148375;525860;524391;1149844;523
ISIC_0014712;150;4;1;1.0;0.6;6621;4422;29278062;1800792;16333470;1800792;24292916;7959446;18134262;168
ISIC_0003657;350;4;3;1.0;0.6;3024;2016;6096384;1523850;2927;1523850;340261;337334;1526777;418
ISIC_0003657;150;2;1;10.0;0.6;3024;2016;6096384;2215635;1986;2215635;340261;338275;2217621;139
ISIC_0013128;150;2;1;1.0;0.6;3872;2592;10036224;5812950;0;5812950;470897;470897;5812950;138
ISIC_0007332;50;3;3;1.0;0.6;3024;2016;6096384;5116843;0;5116843;530766;530766;5116843;43
ISIC_0008524;200;1;1;100.0;0.6;4288;2848;12212224;4726771;11825;4726771;323767;311942;4738596;185
ISIC_0007332;200;1;1;100.0;0.6;3024;2016;6096384;5168995;0;5168995;530766;530766;5168995;185
ISIC_0012547;450;2;2;0.01;0.6;4288;2848;12212224;11248229;40882;11248229;572681;531799;11289111;501
ISIC_0008524;350;3;3;0.1;0.6;4288;2848;12212224;4165348;193;4165348;323767;323574;4165541;402
ISIC_0003657;400;4;3;10.0;0.6;3024;2016;6096384;1481867;3890;1481867;340261;336371;1485757;479
ISIC_0014623;50;2;3;0.01;0.6;2592;1936;5018112;2235623;390972;2235623;1937167;1546195;2626595;26
ISIC_0007332;450;2;1;0.01;0.6;3024;2016;6096384;4696411;0;4696411;530766;530766;4696411;496
ISIC_0012547;50;2;2;0.1;0.6;4288;2848;12212224;0;572681;0;572681;0;572681;22
ISIC_0012547;400;4;1;0.01;0.6;4288;2848;12212224;11289215;75780;11289215;572681;496901;11364995;466
ISIC_0008524;250;4;2;0.1;0.6;4288;2848;12212224;3793835;5288;3793835;323767;318479;3799123;292
ISIC_0008524;300;1;2;1.0;0.6;4288;2848;12212224;4449519;11770;4449519;323767;311997;4461289;308
ISIC_0008524;250;3;2;100.0;0.6;4288;2848;12212224;4328308;7441;4328308;323767;316326;4335749;280
ISIC_0008524;350;3;1;0.01;0.6;4288;2848;12212224;4080366;4205;4080366;323767;319562;4084571;391
ISIC_0014623;50;2;1;1.0;0.6;2592;1936;5018112;2054428;437151;2054428;1937167;1500016;2491579;18
ISIC_0003657;300;2;2;0.1;0.6;3024;2016;6096384;1794742;0;1794742;340261;340261;1794742;322
ISIC_0014712;400;4;3;0.01;0.6;6621;4422;29278062;1028702;18729971;1028702;24292916;5562945;19758673;476
ISIC_0014712;350;3;2;100.0;0.6;6621;4422;29278062;1248110;17167363;1248110;24292916;7125553;18415473;400
ISIC_0013082;50;2;3;100.0;0.6;3872;2592;10036224;3808844;0;3808844;254836;254836;3808844;30
ISIC_0007332;100;1;3;100.0;0.6;3024;2016;6096384;0;530766;0;530766;0;530766;75
ISIC_0014623;350;1;3;0.01;0.6;2592;1936;5018112;1176907;960437;1176907;1937167;976730;2137344;371
ISIC_0003657;300;3;2;100.0;0.6;3024;2016;6096384;1602995;2337;1602995;340261;337924;1605332;340
ISIC_0013188;300;4;2;1.0;0.6;3008;2000;6016000;3655694;35;3655694;92544;92509;3655729;353
ISIC_0003657;200;4;3;0.01;0.6;3024;2016;6096384;1640143;29297;1640143;340261;310964;1669440;236
ISIC_0013082;400;3;3;0.01;0.6;3872;2592;10036224;1392832;12765;1392832;254836;242071;1405597;461
ISIC_0012547;300;2;3;0.1;0.6;4288;2848;12212224;11420733;0;11420733;572681;572681;11420733;327
ISIC_0008524;350;3;3;100.0;0.6;4288;2848;12212224;4100594;277;4100594;323767;323490;4100871;405
ISIC_0014428;250;4;2;100.0;0.6;4288;2848;12212224;1317627;4628;1317627;525860;521232;1322255;295
ISIC_0013188;150;4;3;100.0;0.6;3008;2000;6016000;4437179;0;4437179;92544;92544;4437179;180
ISIC_0007332;450;1;1;0.1;0.6;3024;2016;6096384;4569074;0;4569074;530766;530766;4569074;482
ISIC_0003657;100;3;2;0.1;0.6;3024;2016;6096384;2604993;75;2604993;340261;340186;2605068;97
ISIC_0014712;150;4;3;0.1;0.6;6621;4422;29278062;1742534;16576246;1742534;24292916;7716670;18318780;177
ISIC_0014712;50;4;2;0.01;0.6;6621;4422;29278062;3085643;13679700;3085643;24292916;10613216;16765343;51
ISIC_0013128;150;1;2;10.0;0.6;3872;2592;10036224;5946074;0;5946074;470897;470897;5946074;129
ISIC_0013128;400;3;1;1.0;0.6;3872;2592;10036224;4634077;0;4634077;470897;470897;4634077;453
ISIC_0007332;250;4;3;0.1;0.6;3024;2016;6096384;5103209;1027;5103209;530766;529739;5104236;297
ISIC_0013188;350;3;1;0.01;0.6;3008;2000;6016000;3593886;0;3593886;92544;92544;3593886;391
ISIC_0003657;200;3;2;100.0;0.6;3024;2016;6096384;1814256;1527;1814256;340261;338734;1815783;220
ISIC_0003657;400;1;2;10.0;0.6;3024;2016;6096384;1781219;3890;1781219;340261;336371;1785109;429
ISIC_0013082;400;3;3;10.0;0.6;3872;2592;10036224;1834362;0;1834362;254836;254836;1834362;464
ISIC_0012547;300;2;1;100.0;0.6;4288;2848;12212224;11388053;40804;11388053;572681;531877;11428857;320
ISIC_0014428;300;2;2;0.1;0.6;4288;2848;12212224;1220137;1085;1220137;525860;524775;1221222;322
ISIC_0008524;100;4;2;0.1;0.6;4288;2848;12212224;5178087;7874;5178087;323767;315893;5185961;112
ISIC_0014712;100;4;2;0.01;0.6;6621;4422;29278062;3075277;15339620;3075277;24292916;8953296;18414897;111
ISIC_0014428;100;4;1;10.0;0.6;4288;2848;12212224;2370996;539;2370996;525860;525321;2371535;109
ISIC_0014428;200;1;3;10.0;0.6;4288;2848;12212224;1568841;999;1568841;525860;524861;1569840;194
ISIC_0014712;400;1;1;0.1;0.6;6621;4422;29278062;1369904;16501457;1369904;24292916;7791459;17871361;422
ISIC_0014623;250;2;3;0.1;0.6;2592;1936;5018112;1244414;969386;1244414;1937167;967781;2213800;267
ISIC_0014623;250;2;2;100.0;0.6;2592;1936;5018112;1266679;966718;1266679;1937167;970449;2233397;265
ISIC_0013128;450;2;1;0.01;0.6;3872;2592;10036224;4843771;0;4843771;470897;470897;4843771;496
ISIC_0014712;100;3;1;0.01;0.6;6621;4422;29278062;3368756;13980533;3368756;24292916;10312383;17349289;91
ISIC_0007332;450;1;3;0.1;0.6;3024;2016;6096384;4620303;0;4620303;530766;530766;4620303;492
ISIC_0003657;450;3;1;0.1;0.6;3024;2016;6096384;1496457;0;1496457;340261;340261;1496457;512
ISIC_0013128;50;1;1;1.0;0.6;3872;2592;10036224;6961229;0;6961229;470897;470897;6961229;3
ISIC_0007332;250;4;1;100.0;0.6;3024;2016;6096384;5150273;895;5150273;530766;529871;5151168;290
ISIC_0012547;450;4;3;100.0;0.6;4288;2848;12212224;11029056;108900;11029056;572681;463781;11137956;540
ISIC_0013128;50;2;1;10.0;0.6;3872;2592;10036224;6970975;0;6970975;470897;470897;6970975;19
ISIC_0013188;100;4;2;1.0;0.6;3008;2000;6016000;4738160;0;4738160;92544;92544;4738160;113
ISIC_0007332;400;4;1;1.0;0.6;3024;2016;6096384;4750809;0;4750809;530766;530766;4750809;468
ISIC_0007332;300;1;3;100.0;0.6;3024;2016;6096384;5108871;0;5108871;530766;530766;5108871;315
ISIC_0007332;400;3;1;0.01;0.6;3024;2016;6096384;4784881;0;4784881;530766;530766;4784881;451
ISIC_0013128;250;1;1;1.0;0.6;3872;2592;10036224;5441121;0;5441121;470897;470897;5441121;243
ISIC_0012547;350;2;2;1.0;0.6;4288;2848;12212224;11254275;36527;11254275;572681;536154;11290802;383
ISIC_0013188;150;2;2;0.1;0.6;3008;2000;6016000;4436859;0;4436859;92544;92544;4436859;142
ISIC_0013188;400;2;2;10.0;0.6;3008;2000;6016000;3249918;0;3249918;92544;92544;3249918;444
ISIC_0008524;150;4;3;0.1;0.6;4288;2848;12212224;4474428;0;4474428;323767;323767;4474428;177
ISIC_0014428;350;4;1;100.0;0.6;4288;2848;12212224;1197904;6259;1197904;525860;519601;1204163;410
ISIC_0013082;450;4;3;0.1;0.6;3872;2592;10036224;1503566;1529;1503566;254836;253307;1505095;537
ISIC_0008524;350;3;2;0.01;0.6;4288;2848;12212224;4051614;4651;4051614;323767;319116;4056265;396
ISIC_0003657;150;1;3;1.0;0.6;3024;2016;6096384;2459037;2033;2459037;340261;338228;2461070;133
ISIC_0012547;100;2;1;1.0;0.6;4288;2848;12212224;0;572681;0;572681;0;572681;78
ISIC_0013188;200;4;1;1.0;0.6;3008;2000;6016000;4029013;0;4029013;92544;92544;4029013;228
ISIC_0014712;100;2;2;0.1;0.6;6621;4422;29278062;3199136;12343680;3199136;24292916;11949236;15542816;82
ISIC_0014712;350;2;1;1.0;0.6;6621;4422;29278062;1252250;17087906;1252250;24292916;7205010;18340156;378
ISIC_0012547;450;2;1;0.1;0.6;4288;2848;12212224;11234444;57553;11234444;572681;515128;11291997;497
ISIC_0003657;400;3;3;10.0;0.6;3024;2016;6096384;1539018;3890;1539018;340261;336371;1542908;464
ISIC_0014623;50;3;1;1.0;0.6;2592;1936;5018112;2054241;437131;2054241;1937167;1500036;2491372;33
ISIC_0013128;50;1;2;1.0;0.6;3872;2592;10036224;6961280;0;6961280;470897;470897;6961280;8
ISIC_0014428;450;3;2;0.01;0.6;4288;2848;12212224;828713;6938;828713;525860;518922;835651;516
ISIC_0008524;50;1;3;0.1;0.6;4288;2848;12212224;7579241;0;7579241;323767;323767;7579241;12
ISIC_0013082;450;2;1;0.1;0.6;3872;2592;10036224;1537603;0;1537603;254836;254836;1537603;497
ISIC_0014712;300;2;3;0.1;0.6;6621;4422;29278062;1372721;17184845;1372721;24292916;7108071;18557566;327
ISIC_0008524;100;1;3;1.0;0.6;4288;2848;12212224;5764830;1988;5764830;323767;321779;5766818;73
ISIC_0013082;250;4;1;10.0;0.6;3872;2592;10036224;2106229;0;2106229;254836;254836;2106229;289
ISIC_0014712;100;3;2;10.0;0.6;6621;4422;29278062;3327018;12430905;3327018;24292916;11862011;15757923;99
ISIC_0012547;300;1;1;1.0;0.6;4288;2848;12212224;11387919;0;11387919;572681;572681;11387919;303
ISIC_0013082;300;2;2;0.1;0.6;3872;2592;10036224;1915110;7768;1915110;254836;247068;1922878;322
ISIC_0013128;150;1;3;100.0;0.6;3872;2592;10036224;5945837;0;5945837;470897;470897;5945837;135
ISIC_0008524;300;2;2;10.0;0.6;4288;2848;12212224;4395445;4070;4395445;323767;319697;4399515;324
ISIC_0013128;250;2;3;1.0;0.6;3872;2592;10036224;5441737;0;5441737;470897;470897;5441737;268
ISIC_0013128;450;4;3;100.0;0.6;3872;2592;10036224;4438033;0;4438033;470897;470897;4438033;540
ISIC_0008524;300;1;1;10.0;0.6;4288;2848;12212224;4439506;4070;4439506;323767;319697;4443576;304
ISIC_0003657;350;4;1;10.0;0.6;3024;2016;6096384;1523824;2927;1523824;340261;337334;1526751;409
ISIC_0012547;450;3;1;0.1;0.6;4288;2848;12212224;11207559;85289;11207559;572681;487392;11292848;512
ISIC_0008524;200;3;3;100.0;0.6;4288;2848;12212224;4547314;11825;4547314;323767;311942;4559139;225
ISIC_0008524;400;2;2;0.01;0.6;4288;2848;12212224;3966910;7078;3966910;323767;316689;3973988;441
ISIC_0008524;200;3;2;0.1;0.6;4288;2848;12212224;4725000;3190;4725000;323767;320577;4728190;217
ISIC_0012547;100;1;2;100.0;0.6;4288;2848;12212224;0;572681;0;572681;0;572681;70
ISIC_0007332;100;4;3;10.0;0.6;3024;2016;6096384;0;530766;0;530766;0;530766;119
ISIC_0008524;150;3;2;0.1;0.6;4288;2848;12212224;5192020;0;5192020;323767;323767;5192020;157
ISIC_0008524;400;3;1;1.0;0.6;4288;2848;12212224;3944409;3641;3944409;323767;320126;3948050;453
ISIC_0014712;200;1;3;0.1;0.6;6621;4422;29278062;1528795;15120068;1528795;24292916;9172848;16648863;192
ISIC_0003657;450;1;1;0.01;0.6;3024;2016;6096384;1779714;0;1779714;340261;340261;1779714;481
ISIC_0012547;150;1;2;0.01;0.6;4288;2848;12212224;0;572681;0;572681;0;572681;126
ISIC_0013188;150;1;1;100.0;0.6;3008;2000;6016000;4477530;0;4477530;92544;92544;4477530;125
ISIC_0013082;350;1;1;0.01;0.6;3872;2592;10036224;1958961;0;1958961;254836;254836;1958961;361
ISIC_0008524;100;4;3;0.1;0.6;4288;2848;12212224;5179906;8279;5179906;323767;315488;5188185;117
ISIC_0013128;400;4;2;0.01;0.6;3872;2592;10036224;4618750;0;4618750;470897;470897;4618750;471
ISIC_0014623;150;4;3;100.0;0.6;2592;1936;5018112;1336553;887002;1336553;1937167;1050165;2223555;180
ISIC_0008524;450;1;2;0.1;0.6;4288;2848;12212224;4050479;8457;4050479;323767;315310;4058936;487
ISIC_0003657;350;2;3;0.1;0.6;3024;2016;6096384;1731820;0;1731820;340261;340261;1731820;387
ISIC_0012547;100;4;1;100.0;0.6;4288;2848;12212224;0;572681;0;572681;0;572681;110
ISIC_0013128;400;2;3;0.01;0.6;3872;2592;10036224;4702729;0;4702729;470897;470897;4702729;446
ISIC_0013082;350;1;2;0.1;0.6;3872;2592;10036224;1619377;0;1619377;254836;254836;1619377;367
ISIC_0003657;200;3;1;1.0;0.6;3024;2016;6096384;1843240;359;1843240;340261;339902;1843599;213
ISIC_0014428;200;1;3;0.1;0.6;4288;2848;12212224;1688695;0;1688695;525860;525860;1688695;192
ISIC_0007332;350;1;2;1.0;0.6;3024;2016;6096384;4872482;0;4872482;530766;530766;4872482;368
ISIC_0008524;400;1;2;100.0;0.6;4288;2848;12212224;4134663;13085;4134663;323767;310682;4147748;430
ISIC_0007332;200;3;2;10.0;0.6;3024;2016;6096384;5168793;0;5168793;530766;530766;5168793;219
ISIC_0003657;200;2;3;10.0;0.6;3024;2016;6096384;1934557;304;1934557;340261;339957;1934861;209
ISIC_0013128;50;4;3;0.01;0.6;3872;2592;10036224;7682599;0;7682599;470897;470897;7682599;56
ISIC_0013128;50;4;1;1.0;0.6;3872;2592;10036224;6780246;0;6780246;470897;470897;6780246;48
ISIC_0013128;100;4;3;1.0;0.6;3872;2592;10036224;6458813;0;6458813;470897;470897;6458813;118
ISIC_0008524;250;3;1;100.0;0.6;4288;2848;12212224;4328086;7441;4328086;323767;316326;4335527;275
ISIC_0013082;450;4;1;1.0;0.6;3872;2592;10036224;1743048;3704;1743048;254836;251132;1746752;528
ISIC_0008524;400;1;3;1.0;0.6;4288;2848;12212224;4150835;3862;4150835;323767;319905;4154697;433
ISIC_0013188;150;1;1;10.0;0.6;3008;2000;6016000;4477530;0;4477530;92544;92544;4477530;124
ISIC_0014428;50;1;1;0.01;0.6;4288;2848;12212224;3844219;0;3844219;525860;525860;3844219;1
ISIC_0013188;300;3;3;0.1;0.6;3008;2000;6016000;3660936;0;3660936;92544;92544;3660936;342
ISIC_0014712;50;4;3;100.0;0.6;6621;4422;29278062;2259568;13772366;2259568;24292916;10520550;16031934;60
ISIC_0003657;50;1;2;10.0;0.6;3024;2016;6096384;2883873;72;2883873;340261;340189;2883945;9
ISIC_0013128;350;1;3;0.1;0.6;3872;2592;10036224;5075315;0;5075315;470897;470897;5075315;372
ISIC_0014428;250;2;3;100.0;0.6;4288;2848;12212224;1366468;4628;1366468;525860;521232;1371096;270
ISIC_0003657;50;3;3;10.0;0.6;3024;2016;6096384;2191918;72;2191918;340261;340189;2191990;44
ISIC_0013188;250;3;1;10.0;0.6;3008;2000;6016000;3820281;0;3820281;92544;92544;3820281;274
ISIC_0013082;150;3;3;1.0;0.6;3872;2592;10036224;2689894;2340;2689894;254836;252496;2692234;163
ISIC_0014428;50;4;2;1.0;0.6;4288;2848;12212224;3159468;1756;3159468;525860;524104;3161224;53
ISIC_0007332;400;2;1;0.1;0.6;3024;2016;6096384;4697309;5211;4697309;530766;525555;4702520;437
ISIC_0013082;100;1;3;0.01;0.6;3872;2592;10036224;3061230;10666;3061230;254836;244170;3071896;71
ISIC_0013188;350;3;2;0.1;0.6;3008;2000;6016000;3319516;0;3319516;92544;92544;3319516;397
ISIC_0007332;200;1;3;0.1;0.6;3024;2016;6096384;5211959;0;5211959;530766;530766;5211959;192
ISIC_0008524;100;2;1;10.0;0.6;4288;2848;12212224;5531449;4777;5531449;323767;318990;5536226;79
ISIC_0013188;200;1;2;10.0;0.6;3008;2000;6016000;4007592;0;4007592;92544;92544;4007592;189
ISIC_0013128;350;1;3;10.0;0.6;3872;2592;10036224;5025647;0;5025647;470897;470897;5025647;374
ISIC_0012547;250;4;2;100.0;0.6;4288;2848;12212224;11494346;0;11494346;572681;572681;11494346;295
ISIC_0014428;300;2;1;0.01;0.6;4288;2848;12212224;1496836;384;1496836;525860;525476;1497220;316
ISIC_0012547;400;4;1;0.1;0.6;4288;2848;12212224;11236013;91452;11236013;572681;481229;11327465;467
ISIC_0012547;50;1;3;10.0;0.6;4288;2848;12212224;10812132;0;10812132;572681;572681;10812132;14
ISIC_0013188;350;3;3;10.0;0.6;3008;2000;6016000;3510357;0;3510357;92544;92544;3510357;404
ISIC_0013082;50;4;2;0.01;0.6;3872;2592;10036224;3888074;0;3888074;254836;254836;3888074;51
ISIC_0013128;50;3;2;0.01;0.6;3872;2592;10036224;7694053;0;7694053;470897;470897;7694053;36
ISIC_0013128;400;1;2;10.0;0.6;3872;2592;10036224;4736368;0;4736368;470897;470897;4736368;429
ISIC_0014428;50;2;2;10.0;0.6;4288;2848;12212224;2715605;1211;2715605;525860;524649;2716816;24
ISIC_0003657;350;4;2;0.01;0.6;3024;2016;6096384;1544718;15666;1544718;340261;324595;1560384;411
ISIC_0007332;50;2;1;0.01;0.6;3024;2016;6096384;0;530766;0;530766;0;530766;16
ISIC_0014428;250;1;1;0.01;0.6;4288;2848;12212224;1582280;0;1582280;525860;525860;1582280;241
ISIC_0007332;350;4;3;0.1;0.6;3024;2016;6096384;4775143;687;4775143;530766;530079;4775830;417
ISIC_0013188;100;3;1;1.0;0.6;3008;2000;6016000;4800282;0;4800282;92544;92544;4800282;93
ISIC_0013188;350;4;1;100.0;0.6;3008;2000;6016000;3509667;0;3509667;92544;92544;3509667;410
ISIC_0014712;200;2;3;100.0;0.6;6621;4422;29278062;1408737;16226782;1408737;24292916;8066134;17635519;210
ISIC_0014428;200;3;3;10.0;0.6;4288;2848;12212224;1500193;999;1500193;525860;524861;1501192;224
ISIC_0003657;300;1;1;100.0;0.6;3024;2016;6096384;1919006;2337;1919006;340261;337924;1921343;305
ISIC_0008524;450;3;3;0.01;0.6;4288;2848;12212224;3796760;2993;3796760;323767;320774;3799753;521
ISIC_0003657;100;3;1;0.01;0.6;3024;2016;6096384;2816737;0;2816737;340261;340261;2816737;91
ISIC_0003657;100;1;2;0.1;0.6;3024;2016;6096384;2847947;0;2847947;340261;340261;2847947;67
ISIC_0012547;150;3;3;1.0;0.6;4288;2848;12212224;11558124;0;11558124;572681;572681;11558124;163
ISIC_0012547;300;2;1;0.01;0.6;4288;2848;12212224;11498063;0;11498063;572681;572681;11498063;316
ISIC_0013082;300;2;1;100.0;0.6;3872;2592;10036224;2200671;224;2200671;254836;254612;2200895;320
ISIC_0003657;350;2;1;0.01;0.6;3024;2016;6096384;1864154;0;1864154;340261;340261;1864154;376
ISIC_0012547;450;4;3;10.0;0.6;4288;2848;12212224;11029056;108900;11029056;572681;463781;11137956;539
ISIC_0003657;450;4;2;0.01;0.6;3024;2016;6096384;1382992;21358;1382992;340261;318903;1404350;531
ISIC_0014623;150;1;2;1.0;0.6;2592;1936;5018112;1601068;679338;1601068;1937167;1257829;2280406;128
ISIC_0014428;100;4;3;10.0;0.6;4288;2848;12212224;2370987;539;2370987;525860;525321;2371526;119
ISIC_0013082;400;3;1;1.0;0.6;3872;2592;10036224;1813725;0;1813725;254836;254836;1813725;453
ISIC_0008524;350;1;1;0.1;0.6;4288;2848;12212224;4252672;161;4252672;323767;323606;4252833;362
ISIC_0012547;400;3;1;0.1;0.6;4288;2848;12212224;11231956;66906;11231956;572681;505775;11298862;452
ISIC_0013128;400;2;3;0.1;0.6;3872;2592;10036224;4734097;0;4734097;470897;470897;4734097;447
ISIC_0013128;250;2;2;0.1;0.6;3872;2592;10036224;5348175;0;5348175;470897;470897;5348175;262
ISIC_0013188;250;3;2;0.01;0.6;3008;2000;6016000;3987173;0;3987173;92544;92544;3987173;276
ISIC_0007332;350;2;1;1.0;0.6;3024;2016;6096384;4872674;0;4872674;530766;530766;4872674;378
ISIC_0014623;300;1;2;1.0;0.6;2592;1936;5018112;1226330;956693;1226330;1937167;980474;2183023;308
ISIC_0013082;200;3;3;0.1;0.6;3872;2592;10036224;2148017;1693;2148017;254836;253143;2149710;222
ISIC_0012547;50;4;1;100.0;0.6;4288;2848;12212224;10811707;0;10811707;572681;572681;10811707;50
ISIC_0014623;450;4;2;10.0;0.6;2592;1936;5018112;875633;1217578;875633;1937167;719589;2093211;534
ISIC_0012547;150;2;1;0.01;0.6;4288;2848;12212224;0;572681;0;572681;0;572681;136
ISIC_0013188;250;4;3;100.0;0.6;3008;2000;6016000;3844063;0;3844063;92544;92544;3844063;300
ISIC_0012547;200;3;3;0.1;0.6;4288;2848;12212224;11513923;0;11513923;572681;572681;11513923;222
ISIC_0003657;250;3;1;10.0;0.6;3024;2016;6096384;1772117;296;1772117;340261;339965;1772413;274
ISIC_0008524;300;4;3;0.01;0.6;4288;2848;12212224;3835876;400;3835876;323767;323367;3836276;356
ISIC_0013128;300;3;3;0.1;0.6;3872;2592;10036224;5040436;0;5040436;470897;470897;5040436;342
ISIC_0014623;100;2;3;10.0;0.6;2592;1936;5018112;1582360;624499;1582360;1937167;1312668;2206859;89
ISIC_0014712;450;1;3;0.01;0.6;6621;4422;29278062;928969;17015604;928969;24292916;7277312;17944573;491
ISIC_0014712;100;1;1;0.01;0.6;6621;4422;29278062;3718161;11195197;3718161;24292916;13097719;14913358;61
ISIC_0008524;250;1;2;1.0;0.6;4288;2848;12212224;4539371;8357;4539371;323767;315410;4547728;248
ISIC_0003657;350;3;1;10.0;0.6;3024;2016;6096384;1613717;2927;1613717;340261;337334;1616644;394
ISIC_0014623;200;4;3;100.0;0.6;2592;1936;5018112;1160551;976721;1160551;1937167;960446;2137272;240
ISIC_0014712;450;1;3;1.0;0.6;6621;4422;29278062;1065518;17255482;1065518;24292916;7037434;18321000;493
ISIC_0013082;400;4;1;0.1;0.6;3872;2592;10036224;1512356;4981;1512356;254836;249855;1517337;467
ISIC_0007332;350;2;1;0.01;0.6;3024;2016;6096384;4828809;0;4828809;530766;530766;4828809;376
ISIC_0003657;350;3;2;1.0;0.6;3024;2016;6096384;1614280;2927;1614280;340261;337334;1617207;398
ISIC_0012547;350;2;1;0.01;0.6;4288;2848;12212224;11396939;0;11396939;572681;572681;11396939;376
ISIC_0014623;100;2;2;0.1;0.6;2592;1936;5018112;1662858;548102;1662858;1937167;1389065;2210960;82
ISIC_0013082;450;4;2;10.0;0.6;3872;2592;10036224;1722795;1608;1722795;254836;253228;1724403;534
ISIC_0012547;250;3;1;0.1;0.6;4288;2848;12212224;11534007;0;11534007;572681;572681;11534007;272
ISIC_0014623;450;1;2;1.0;0.6;2592;1936;5018112;1098599;1022487;1098599;1937167;914680;2121086;488
ISIC_0014428;200;3;1;100.0;0.6;4288;2848;12212224;1500209;999;1500209;525860;524861;1501208;215
ISIC_0003657;300;3;2;10.0;0.6;3024;2016;6096384;1603000;2337;1603000;340261;337924;1605337;339
ISIC_0012547;250;4;2;0.1;0.6;4288;2848;12212224;11532844;47731;11532844;572681;524950;11580575;292
ISIC_0013128;100;1;1;0.1;0.6;3872;2592;10036224;6875600;0;6875600;470897;470897;6875600;62
ISIC_0007332;150;4;2;0.01;0.6;3024;2016;6096384;5435327;0;5435327;530766;530766;5435327;171
ISIC_0014623;400;1;3;1.0;0.6;2592;1936;5018112;1174009;967998;1174009;1937167;969169;2142007;433
ISIC_0008524;450;4;1;100.0;0.6;4288;2848;12212224;2777495;18436;2777495;323767;305331;2795931;530
ISIC_0013188;50;1;3;100.0;0.6;3008;2000;6016000;5061950;0;5061950;92544;92544;5061950;15
ISIC_0014428;200;1;3;0.01;0.6;4288;2848;12212224;1476984;2993;1476984;525860;522867;1479977;191
ISIC_0014428;100;2;1;10.0;0.6;4288;2848;12212224;2634492;538;2634492;525860;525322;2635030;79
ISIC_0008524;200;1;2;100.0;0.6;4288;2848;12212224;4726491;11825;4726491;323767;311942;4738316;190
ISIC_0007332;50;4;2;10.0;0.6;3024;2016;6096384;5150076;0;5150076;530766;530766;5150076;54
ISIC_0014712;150;1;3;0.01;0.6;6621;4422;29278062;1888060;12931890;1888060;24292916;11361026;14819950;131
ISIC_0013188;250;2;1;100.0;0.6;3008;2000;6016000;3820281;0;3820281;92544;92544;3820281;260
ISIC_0003657;250;2;2;0.1;0.6;3024;2016;6096384;1873150;465;1873150;340261;339796;1873615;262
ISIC_0014712;300;1;3;100.0;0.6;6621;4422;29278062;1326291;15822373;1326291;24292916;8470543;17148664;315
ISIC_0013082;400;2;1;0.01;0.6;3872;2592;10036224;1744530;0;1744530;254836;254836;1744530;436
ISIC_0014428;50;2;3;0.1;0.6;4288;2848;12212224;3030687;0;3030687;525860;525860;3030687;27
ISIC_0014428;400;3;1;1.0;0.6;4288;2848;12212224;1014106;4512;1014106;525860;521348;1018618;453
ISIC_0014623;200;3;3;0.01;0.6;2592;1936;5018112;1196871;899353;1196871;1937167;1037814;2096224;221
ISIC_0008524;250;3;1;0.01;0.6;4288;2848;12212224;4618413;0;4618413;323767;323767;4618413;271
ISIC_0007332;450;1;2;1.0;0.6;3024;2016;6096384;4697358;83;4697358;530766;530683;4697441;488
ISIC_0014623;150;1;1;0.1;0.6;2592;1936;5018112;1659583;767464;1659583;1937167;1169703;2427047;122
ISIC_0014623;350;3;3;10.0;0.6;2592;1936;5018112;1040077;1054531;1040077;1937167;882636;2094608;404
ISIC_0012547;50;2;3;0.01;0.6;4288;2848;12212224;0;572681;0;572681;0;572681;26
ISIC_0014712;200;4;1;0.01;0.6;6621;4422;29278062;1487978;17045319;1487978;24292916;7247597;18533297;226
ISIC_0013082;250;2;1;100.0;0.6;3872;2592;10036224;2106230;0;2106230;254836;254836;2106230;260
ISIC_0012547;50;3;1;0.01;0.6;4288;2848;12212224;0;572681;0;572681;0;572681;31
ISIC_0003657;50;4;1;0.01;0.6;3024;2016;6096384;3109719;1698;3109719;340261;338563;3111417;46
ISIC_0014428;250;3;1;0.1;0.6;4288;2848;12212224;1383520;0;1383520;525860;525860;1383520;272
ISIC_0013188;50;4;2;100.0;0.6;3008;2000;6016000;4950972;0;4950972;92544;92544;4950972;55
ISIC_0014428;100;2;1;1.0;0.6;4288;2848;12212224;2509061;8777;2509061;525860;517083;2517838;78
ISIC_0013188;200;2;1;0.01;0.6;3008;2000;6016000;4302841;0;4302841;92544;92544;4302841;196
ISIC_0013188;350;2;3;0.01;0.6;3008;2000;6016000;3448373;0;3448373;92544;92544;3448373;386
ISIC_0013082;350;3;3;100.0;0.6;3872;2592;10036224;1955510;0;1955510;254836;254836;1955510;405
ISIC_0014623;150;4;1;0.01;0.6;2592;1936;5018112;1286092;876443;1286092;1937167;1060724;2162535;166
ISIC_0013082;300;2;1;1.0;0.6;3872;2592;10036224;2130874;1535;2130874;254836;253301;2132409;318
ISIC_0003657;300;3;3;0.1;0.6;3024;2016;6096384;1737069;0;1737069;340261;340261;1737069;342
ISIC_0014712;50;4;1;10.0;0.6;6621;4422;29278062;2259591;13772368;2259591;24292916;10520548;16031959;49
ISIC_0014428;450;3;3;100.0;0.6;4288;2848;12212224;1128313;8163;1128313;525860;517697;1136476;525
ISIC_0013082;100;1;2;100.0;0.6;3872;2592;10036224;3103841;0;3103841;254836;254836;3103841;70
ISIC_0014623;200;2;2;100.0;0.6;2592;1936;5018112;1310960;843834;1310960;1937167;1093333;2154794;205
ISIC_0013188;100;1;2;100.0;0.6;3008;2000;6016000;4864422;0;4864422;92544;92544;4864422;70
ISIC_0014428;150;1;1;1.0;0.6;4288;2848;12212224;2068287;2892;2068287;525860;522968;2071179;123
ISIC_0014712;150;2;1;100.0;0.6;6621;4422;29278062;1997847;15165184;1997847;24292916;9127732;17163031;140
ISIC_0014712;300;3;1;0.01;0.6;6621;4422;29278062;1326940;17325684;1326940;24292916;6967232;18652624;331
ISIC_0014428;400;2;2;0.01;0.6;4288;2848;12212224;991451;6143;991451;525860;519717;997594;441
ISIC_0014428;250;2;1;100.0;0.6;4288;2848;12212224;1366468;4628;1366468;525860;521232;1371096;260
ISIC_0012547;300;2;3;10.0;0.6;4288;2848;12212224;11388053;40804;11388053;572681;531877;11428857;329
ISIC_0012547;250;4;1;100.0;0.6;4288;2848;12212224;11494346;0;11494346;572681;572681;11494346;290
ISIC_0014623;150;4;2;0.01;0.6;2592;1936;5018112;1287654;870834;1287654;1937167;1066333;2158488;171
ISIC_0013188;450;3;2;100.0;0.6;3008;2000;6016000;3126245;0;3126245;92544;92544;3126245;520
ISIC_0007332;300;3;3;0.01;0.6;3024;2016;6096384;4994036;0;4994036;530766;530766;4994036;341
ISIC_0014712;200;1;3;0.01;0.6;6621;4422;29278062;1661398;14667157;1661398;24292916;9625759;16328555;191
ISIC_0012547;100;3;2;10.0;0.6;4288;2848;12212224;0;572681;0;572681;0;572681;99
ISIC_0003657;250;1;1;0.01;0.6;3024;2016;6096384;2239144;903;2239144;340261;339358;2240047;241
ISIC_0014623;150;4;1;0.1;0.6;2592;1936;5018112;1308916;912551;1308916;1937167;1024616;2221467;167
ISIC_0003657;300;3;1;0.1;0.6;3024;2016;6096384;1740455;0;1740455;340261;340261;1740455;332
ISIC_0013188;50;3;1;1.0;0.6;3008;2000;6016000;5064321;0;5064321;92544;92544;5064321;33
ISIC_0014712;150;1;1;0.01;0.6;6621;4422;29278062;1898412;12756642;1898412;24292916;11536274;14655054;121
ISIC_0013082;400;2;3;10.0;0.6;3872;2592;10036224;1809398;0;1809398;254836;254836;1809398;449
ISIC_0014623;50;1;1;1.0;0.6;2592;1936;5018112;2352792;422869;2352792;1937167;1514298;2775661;3
ISIC_0013188;450;1;1;10.0;0.6;3008;2000;6016000;3139687;0;3139687;92544;92544;3139687;484
ISIC_0014712;300;1;3;0.1;0.6;6621;4422;29278062;1374393;16268671;1374393;24292916;8024245;17643064;312
ISIC_0014712;50;3;1;1.0;0.6;6621;4422;29278062;2466018;12862339;2466018;24292916;11430577;15328357;33
ISIC_0014712;400;3;1;100.0;0.6;6621;4422;29278062;1239206;17659900;1239206;24292916;6633016;18899106;455
ISIC_0012547;150;3;1;0.01;0.6;4288;2848;12212224;0;572681;0;572681;0;572681;151
ISIC_0014428;400;3;2;100.0;0.6;4288;2848;12212224;1108993;2797;1108993;525860;523063;1111790;460
ISIC_0013082;250;4;2;1.0;0.6;3872;2592;10036224;2106197;0;2106197;254836;254836;2106197;293
ISIC_0013188;300;3;1;10.0;0.6;3008;2000;6016000;3695991;45;3695991;92544;92499;3696036;334
ISIC_0003657;100;1;3;10.0;0.6;3024;2016;6096384;2754355;30;2754355;340261;340231;2754385;74
ISIC_0012547;450;2;3;100.0;0.6;4288;2848;12212224;11254268;54450;11254268;572681;518231;11308718;510
ISIC_0008524;250;4;3;0.1;0.6;4288;2848;12212224;3794712;5158;3794712;323767;318609;3799870;297
ISIC_0008524;50;1;3;0.01;0.6;4288;2848;12212224;7565098;0;7565098;323767;323767;7565098;11
ISIC_0014623;400;3;1;0.1;0.6;2592;1936;5018112;1000897;1147468;1000897;1937167;789699;2148365;452
ISIC_0007332;50;2;2;100.0;0.6;3024;2016;6096384;5139558;0;5139558;530766;530766;5139558;25
ISIC_0014712;350;1;1;1.0;0.6;6621;4422;29278062;1259771;15588615;1259771;24292916;8704301;16848386;363
ISIC_0008524;250;2;1;0.1;0.6;4288;2848;12212224;4568149;4795;4568149;323767;318972;4572944;257
ISIC_0007332;200;3;3;10.0;0.6;3024;2016;6096384;5168488;0;5168488;530766;530766;5168488;224
ISIC_0013128;400;4;1;1.0;0.6;3872;2592;10036224;4483021;0;4483021;470897;470897;4483021;468
ISIC_0013188;200;3;1;0.01;0.6;3008;2000;6016000;4295954;0;4295954;92544;92544;4295954;211
ISIC_0013082;150;3;1;0.01;0.6;3872;2592;10036224;3019181;0;3019181;254836;254836;3019181;151
ISIC_0014712;250;4;2;100.0;0.6;6621;4422;29278062;1784642;17882216;1784642;24292916;6410700;19666858;295
ISIC_0014428;50;4;3;100.0;0.6;4288;2848;12212224;2715317;1211;2715317;525860;524649;2716528;60
ISIC_0007332;200;3;2;0.1;0.6;3024;2016;6096384;5186629;0;5186629;530766;530766;5186629;217
ISIC_0013188;200;1;1;0.1;0.6;3008;2000;6016000;4064820;0;4064820;92544;92544;4064820;182
ISIC_0003657;50;2;1;1.0;0.6;3024;2016;6096384;2634165;53;2634165;340261;340208;2634218;18
ISIC_0013188;300;4;3;10.0;0.6;3008;2000;6016000;3655838;45;3655838;92544;92499;3655883;359
ISIC_0013082;450;3;2;10.0;0.6;3872;2592;10036224;1722795;1608;1722795;254836;253228;1724403;519
ISIC_0014712;250;1;3;100.0;0.6;6621;4422;29278062;2006505;15387117;2006505;24292916;8905799;17393622;255
ISIC_0008524;50;4;3;0.01;0.6;4288;2848;12212224;6532278;21383;6532278;323767;302384;6553661;56
ISIC_0003657;100;4;1;100.0;0.6;3024;2016;6096384;2309953;30;2309953;340261;340231;2309983;110
ISIC_0008524;300;2;2;100.0;0.6;4288;2848;12212224;4395441;4070;4395441;323767;319697;4399511;325
ISIC_0013128;250;4;2;10.0;0.6;3872;2592;10036224;5316906;0;5316906;470897;470897;5316906;294
ISIC_0013188;350;1;3;1.0;0.6;3008;2000;6016000;3508144;0;3508144;92544;92544;3508144;373
ISIC_0014428;150;3;2;0.1;0.6;4288;2848;12212224;1596753;0;1596753;525860;525860;1596753;157
ISIC_0012547;300;3;1;10.0;0.6;4288;2848;12212224;11305031;81608;11305031;572681;491073;11386639;334
ISIC_0014623;450;2;1;0.01;0.6;2592;1936;5018112;1011871;1083724;1011871;1937167;853443;2095595;496
ISIC_0008524;200;2;3;1.0;0.6;4288;2848;12212224;4756174;9613;4756174;323767;314154;4765787;208
ISIC_0013128;200;2;1;1.0;0.6;3872;2592;10036224;5661315;0;5661315;470897;470897;5661315;198
ISIC_0014623;200;2;3;100.0;0.6;2592;1936;5018112;1311139;843883;1311139;1937167;1093284;2155022;210
ISIC_0012547;100;2;3;100.0;0.6;4288;2848;12212224;0;572681;0;572681;0;572681;90
ISIC_0003657;250;4;3;1.0;0.6;3024;2016;6096384;1642932;307;1642932;340261;339954;1643239;298
ISIC_0012547;250;4;1;0.01;0.6;4288;2848;12212224;11563504;0;11563504;572681;572681;11563504;286
ISIC_0008524;200;1;3;1.0;0.6;4288;2848;12212224;4824409;8031;4824409;323767;315736;4832440;193
ISIC_0012547;150;4;1;0.1;0.6;4288;2848;12212224;11555433;0;11555433;572681;572681;11555433;167
ISIC_0003657;150;2;1;100.0;0.6;3024;2016;6096384;2215635;1986;2215635;340261;338275;2217621;140
ISIC_0012547;50;4;2;0.01;0.6;4288;2848;12212224;0;572681;0;572681;0;572681;51
ISIC_0013082;150;4;1;10.0;0.6;3872;2592;10036224;2759695;183;2759695;254836;254653;2759878;169
ISIC_0014623;350;3;2;10.0;0.6;2592;1936;5018112;1040316;1054531;1040316;1937167;882636;2094847;399
ISIC_0013082;300;2;3;1.0;0.6;3872;2592;10036224;2130884;1363;2130884;254836;253473;2132247;328
ISIC_0014712;450;1;3;100.0;0.6;6621;4422;29278062;1065548;17186282;1065548;24292916;7106634;18251830;495
ISIC_0014428;200;2;2;0.01;0.6;4288;2848;12212224;1548890;0;1548890;525860;525860;1548890;201
ISIC_0014428;400;2;3;0.01;0.6;4288;2848;12212224;905565;13775;905565;525860;512085;919340;446
ISIC_0013188;450;1;2;100.0;0.6;3008;2000;6016000;3139701;0;3139701;92544;92544;3139701;490
ISIC_0013082;400;3;3;1.0;0.6;3872;2592;10036224;1813952;0;1813952;254836;254836;1813952;463
ISIC_0014428;450;4;3;100.0;0.6;4288;2848;12212224;1128313;8163;1128313;525860;517697;1136476;540
ISIC_0013082;350;2;1;1.0;0.6;3872;2592;10036224;1953639;0;1953639;254836;254836;1953639;378
ISIC_0014712;100;3;3;0.1;0.6;6621;4422;29278062;3200915;12649840;3200915;24292916;11643076;15850755;102
ISIC_0014712;50;2;3;0.01;0.6;6621;4422;29278062;3276780;11222772;3276780;24292916;13070144;14499552;26
ISIC_0013128;200;4;2;1.0;0.6;3872;2592;10036224;5464230;0;5464230;470897;470897;5464230;233
ISIC_0008524;450;4;2;100.0;0.6;4288;2848;12212224;2777495;18436;2777495;323767;305331;2795931;535
ISIC_0014623;250;1;2;1.0;0.6;2592;1936;5018112;1388713;891076;1388713;1937167;1046091;2279789;248
ISIC_0003657;100;2;3;100.0;0.6;3024;2016;6096384;2565408;30;2565408;340261;340231;2565438;90
ISIC_0014712;250;1;1;0.1;0.6;6621;4422;29278062;2010057;15418141;2010057;24292916;8874775;17428198;242
ISIC_0013128;100;2;1;10.0;0.6;3872;2592;10036224;6775935;0;6775935;470897;470897;6775935;79
ISIC_0008524;400;4;1;1.0;0.6;4288;2848;12212224;3146270;3998;3146270;323767;319769;3150268;468
ISIC_0014428;300;3;1;0.1;0.6;4288;2848;12212224;1177327;821;1177327;525860;525039;1178148;332
ISIC_0014428;250;2;1;0.1;0.6;4288;2848;12212224;1382394;0;1382394;525860;525860;1382394;257
ISIC_0014712;300;3;3;10.0;0.6;6621;4422;29278062;1314378;17477830;1314378;24292916;6815086;18792208;344
ISIC_0013128;300;4;3;1.0;0.6;3872;2592;10036224;4966316;55;4966316;470897;470842;4966371;358
ISIC_0014623;200;4;3;0.01;0.6;2592;1936;5018112;1212778;981564;1212778;1937167;955603;2194342;236
ISIC_0013188;400;4;3;1.0;0.6;3008;2000;6016000;3234278;0;3234278;92544;92544;3234278;478
ISIC_0007332;250;1;1;100.0;0.6;3024;2016;6096384;5174609;895;5174609;530766;529871;5175504;245
ISIC_0008524;350;3;2;0.1;0.6;4288;2848;12212224;4163018;179;4163018;323767;323588;4163197;397
ISIC_0013082;300;3;2;1.0;0.6;3872;2592;10036224;2131081;1486;2131081;254836;253350;2132567;338
ISIC_0003657;150;2;2;0.01;0.6;3024;2016;6096384;2247919;8686;2247919;340261;331575;2256605;141
ISIC_0012547;50;2;1;10.0;0.6;4288;2848;12212224;10812027;0;10812027;572681;572681;10812027;19
ISIC_0012547;300;3;3;100.0;0.6;4288;2848;12212224;11305031;81608;11305031;572681;491073;11386639;345
ISIC_0007332;250;1;1;1.0;0.6;3024;2016;6096384;5174624;895;5174624;530766;529871;5175519;243
ISIC_0008524;400;2;3;100.0;0.6;4288;2848;12212224;3997142;13085;3997142;323767;310682;4010227;450
ISIC_0013128;250;4;3;0.01;0.6;3872;2592;10036224;5319354;0;5319354;470897;470897;5319354;296
ISIC_0014428;250;4;2;0.01;0.6;4288;2848;12212224;1343122;0;1343122;525860;525860;1343122;291
ISIC_0014428;200;4;2;0.1;0.6;4288;2848;12212224;1557473;0;1557473;525860;525860;1557473;232
ISIC_0014712;200;2;2;100.0;0.6;6621;4422;29278062;1408737;16226784;1408737;24292916;8066132;17635521;205
ISIC_0014428;400;4;1;0.1;0.6;4288;2848;12212224;929600;3922;929600;525860;521938;933522;467
ISIC_0014712;250;4;1;0.1;0.6;6621;4422;29278062;1706396;18025532;1706396;24292916;6267384;19731928;287
ISIC_0003657;100;3;1;10.0;0.6;3024;2016;6096384;2439522;30;2439522;340261;340231;2439552;94
ISIC_0014623;400;1;2;0.1;0.6;2592;1936;5018112;1213458;974581;1213458;1937167;962586;2188039;427
ISIC_0013082;100;1;1;100.0;0.6;3872;2592;10036224;3103850;0;3103850;254836;254836;3103850;65
ISIC_0014712;400;1;2;100.0;0.6;6621;4422;29278062;1404245;16479688;1404245;24292916;7813228;17883933;430
ISIC_0012547;250;1;1;0.01;0.6;4288;2848;12212224;11562633;0;11562633;572681;572681;11562633;241
ISIC_0013128;450;4;3;0.01;0.6;3872;2592;10036224;4496553;0;4496553;470897;470897;4496553;536
ISIC_0007332;200;4;3;1.0;0.6;3024;2016;6096384;5168961;0;5168961;530766;530766;5168961;238
ISIC_0013188;50;1;1;1.0;0.6;3008;2000;6016000;5072649;0;5072649;92544;92544;5072649;3
ISIC_0013188;250;3;3;100.0;0.6;3008;2000;6016000;3844063;0;3844063;92544;92544;3844063;285
ISIC_0007332;450;3;3;1.0;0.6;3024;2016;6096384;4683764;83;4683764;530766;530683;4683847;523
ISIC_0014428;250;1;1;1.0;0.6;4288;2848;12212224;1468128;0;1468128;525860;525860;1468128;243
ISIC_0013128;350;2;1;0.01;0.6;3872;2592;10036224;4960693;0;4960693;470897;470897;4960693;376
ISIC_0013128;350;2;1;0.1;0.6;3872;2592;10036224;5067980;0;5067980;470897;470897;5067980;377
ISIC_0013082;250;3;2;10.0;0.6;3872;2592;10036224;2106429;0;2106429;254836;254836;2106429;279
ISIC_0008524;350;4;3;10.0;0.6;4288;2848;12212224;3333252;277;3333252;323767;323490;3333529;419
ISIC_0013082;300;1;3;0.01;0.6;3872;2592;10036224;1772809;8678;1772809;254836;246158;1781487;311
ISIC_0014428;350;3;2;100.0;0.6;4288;2848;12212224;1232873;6259;1232873;525860;519601;1239132;400
ISIC_0012547;350;3;1;10.0;0.6;4288;2848;12212224;11254071;71369;11254071;572681;501312;11325440;394
ISIC_0013082;300;1;1;0.01;0.6;3872;2592;10036224;2226329;2319;2226329;254836;252517;2228648;301
ISIC_0007332;350;3;1;100.0;0.6;3024;2016;6096384;4871959;0;4871959;530766;530766;4871959;395
ISIC_0013188;400;2;3;1.0;0.6;3008;2000;6016000;3234422;0;3234422;92544;92544;3234422;448
ISIC_0014712;100;1;3;10.0;0.6;6621;4422;29278062;3652268;10960385;3652268;24292916;13332531;14612653;74
ISIC_0012547;450;3;1;100.0;0.6;4288;2848;12212224;11227043;108900;11227043;572681;463781;11335943;515
ISIC_0013082;200;3;1;0.1;0.6;3872;2592;10036224;2175586;7011;2175586;254836;247825;2182597;212
ISIC_0008524;100;4;2;100.0;0.6;4288;2848;12212224;5000241;4772;5000241;323767;318995;5005013;115
ISIC_0014428;250;1;1;0.1;0.6;4288;2848;12212224;1513541;0;1513541;525860;525860;1513541;242
ISIC_0012547;450;2;2;10.0;0.6;4288;2848;12212224;11254268;54450;11254268;572681;518231;11308718;504
ISIC_0013082;450;1;1;1.0;0.6;3872;2592;10036224;1742517;3124;1742517;254836;251712;1745641;483
ISIC_0013128;400;2;1;100.0;0.6;3872;2592;10036224;4607531;0;4607531;470897;470897;4607531;440
ISIC_0008524;200;4;2;100.0;0.6;4288;2848;12212224;3962471;11825;3962471;323767;311942;3974296;235
ISIC_0003657;150;4;3;1.0;0.6;3024;2016;6096384;1932427;2025;1932427;340261;338236;1934452;178
ISIC_0003657;300;4;2;100.0;0.6;3024;2016;6096384;1540332;2883;1540332;340261;337378;1543215;355
ISIC_0012547;50;4;2;0.1;0.6;4288;2848;12212224;0;572681;0;572681;0;572681;52
ISIC_0013082;250;4;2;100.0;0.6;3872;2592;10036224;2106430;0;2106430;254836;254836;2106430;295
ISIC_0012547;250;1;2;1.0;0.6;4288;2848;12212224;11493599;0;11493599;572681;572681;11493599;248
ISIC_0014712;100;3;3;100.0;0.6;6621;4422;29278062;3327019;12430726;3327019;24292916;11862190;15757745;105
ISIC_0014623;100;1;2;1.0;0.6;2592;1936;5018112;1676377;580670;1676377;1937167;1356497;2257047;68
ISIC_0003657;100;1;1;100.0;0.6;3024;2016;6096384;2754069;30;2754069;340261;340231;2754099;65
ISIC_0003657;400;4;2;10.0;0.6;3024;2016;6096384;1481931;3890;1481931;340261;336371;1485821;474
ISIC_0013188;250;4;1;100.0;0.6;3008;2000;6016000;3820281;0;3820281;92544;92544;3820281;290
ISIC_0013188;150;4;1;10.0;0.6;3008;2000;6016000;4436995;0;4436995;92544;92544;4436995;169
ISIC_0013188;300;4;3;100.0;0.6;3008;2000;6016000;3655769;45;3655769;92544;92499;3655814;360
ISIC_0014623;150;3;3;10.0;0.6;2592;1936;5018112;1369178;887058;1369178;1937167;1050109;2256236;164
ISIC_0007332;400;3;3;1.0;0.6;3024;2016;6096384;4812083;0;4812083;530766;530766;4812083;463
ISIC_0012547;200;2;3;1.0;0.6;4288;2848;12212224;11260459;0;11260459;572681;572681;11260459;208
ISIC_0013128;200;2;1;0.01;0.6;3872;2592;10036224;5792911;0;5792911;470897;470897;5792911;196
ISIC_0008524;50;4;1;0.01;0.6;4288;2848;12212224;6590830;3722;6590830;323767;320045;6594552;46
ISIC_0014712;50;1;1;10.0;0.6;6621;4422;29278062;2825624;10386461;2825624;24292916;13906455;13212085;4
ISIC_0007332;250;3;3;1.0;0.6;3024;2016;6096384;5150371;895;5150371;530766;529871;5151266;283
ISIC_0013188;50;1;2;0.1;0.6;3008;2000;6016000;5404276;0;5404276;92544;92544;5404276;7
ISIC_0008524;400;4;2;1.0;0.6;4288;2848;12212224;3146617;4025;3146617;323767;319742;3150642;473
ISIC_0003657;200;1;1;0.1;0.6;3024;2016;6096384;2270128;0;2270128;340261;340261;2270128;182
ISIC_0014712;200;3;3;1.0;0.6;6621;4422;29278062;1514065;16606492;1514065;24292916;7686424;18120557;223
ISIC_0007332;400;2;3;10.0;0.6;3024;2016;6096384;4811754;0;4811754;530766;530766;4811754;449
ISIC_0013188;200;4;1;10.0;0.6;3008;2000;6016000;3977654;0;3977654;92544;92544;3977654;229
ISIC_0014712;400;4;1;10.0;0.6;6621;4422;29278062;1232291;18911561;1232291;24292916;5381355;20143852;469
ISIC_0013188;450;4;3;0.1;0.6;3008;2000;6016000;3106534;0;3106534;92544;92544;3106534;537
ISIC_0007332;450;1;3;100.0;0.6;3024;2016;6096384;4697322;83;4697322;530766;530683;4697405;495
ISIC_0013082;350;1;1;1.0;0.6;3872;2592;10036224;1953639;0;1953639;254836;254836;1953639;363
ISIC_0014712;50;4;3;0.01;0.6;6621;4422;29278062;3061395;14290853;3061395;24292916;10002063;17352248;56
ISIC_0003657;150;4;1;0.1;0.6;3024;2016;6096384;2074732;6934;2074732;340261;333327;2081666;167
ISIC_0014623;100;3;1;1.0;0.6;2592;1936;5018112;1616921;719552;1616921;1937167;1217615;2336473;93
ISIC_0003657;150;3;1;10.0;0.6;3024;2016;6096384;2093540;1986;2093540;340261;338275;2095526;154
ISIC_0008524;300;3;1;100.0;0.6;4288;2848;12212224;4263919;4070;4263919;323767;319697;4267989;335
ISIC_0014623;250;3;1;0.01;0.6;2592;1936;5018112;1212881;952507;1212881;1937167;984660;2165388;271
ISIC_0013128;350;1;2;0.01;0.6;3872;2592;10036224;5038002;0;5038002;470897;470897;5038002;366
ISIC_0013188;450;4;1;10.0;0.6;3008;2000;6016000;3126240;0;3126240;92544;92544;3126240;529
ISIC_0012547;400;1;3;1.0;0.6;4288;2848;12212224;11250321;0;11250321;572681;572681;11250321;433
ISIC_0003657;350;2;3;0.01;0.6;3024;2016;6096384;1670142;14755;1670142;340261;325506;1684897;386
ISIC_0012547;200;1;1;1.0;0.6;4288;2848;12212224;11264016;0;11264016;572681;572681;11264016;183
ISIC_0013128;100;2;3;0.01;0.6;3872;2592;10036224;6728591;0;6728591;470897;470897;6728591;86
ISIC_0008524;200;4;3;0.1;0.6;4288;2848;12212224;4179964;11226;4179964;323767;312541;4191190;237
ISIC_0008524;350;1;3;1.0;0.6;4288;2848;12212224;4244263;2997;4244263;323767;320770;4247260;373
ISIC_0013128;100;4;1;0.1;0.6;3872;2592;10036224;6677435;0;6677435;470897;470897;6677435;107
ISIC_0008524;400;2;2;10.0;0.6;4288;2848;12212224;3997012;13085;3997012;323767;310682;4010097;444
ISIC_0007332;150;2;1;10.0;0.6;3024;2016;6096384;5525218;0;5525218;530766;530766;5525218;139
ISIC_0012547;100;3;2;100.0;0.6;4288;2848;12212224;0;572681;0;572681;0;572681;100
ISIC_0003657;450;3;2;10.0;0.6;3024;2016;6096384;1411826;1807;1411826;340261;338454;1413633;519
ISIC_0007332;250;3;2;0.1;0.6;3024;2016;6096384;5101962;1119;5101962;530766;529647;5103081;277
ISIC_0013082;450;2;1;100.0;0.6;3872;2592;10036224;1722804;1608;1722804;254836;253228;1724412;500
ISIC_0014428;200;1;2;100.0;0.6;4288;2848;12212224;1568875;999;1568875;525860;524861;1569874;190
ISIC_0014428;450;4;2;1.0;0.6;4288;2848;12212224;1148695;1595;1148695;525860;524265;1150290;533
ISIC_0014428;200;4;3;100.0;0.6;4288;2848;12212224;1439200;999;1439200;525860;524861;1440199;240
ISIC_0014428;200;4;1;100.0;0.6;4288;2848;12212224;1439200;999;1439200;525860;524861;1440199;230
ISIC_0013128;300;1;1;100.0;0.6;3872;2592;10036224;5178423;39;5178423;470897;470858;5178462;305
ISIC_0007332;150;4;1;10.0;0.6;3024;2016;6096384;5525218;0;5525218;530766;530766;5525218;169
ISIC_0003657;250;2;1;0.1;0.6;3024;2016;6096384;1887937;432;1887937;340261;339829;1888369;257
ISIC_0008524;350;3;2;10.0;0.6;4288;2848;12212224;4100146;277;4100146;323767;323490;4100423;399
ISIC_0007332;350;3;2;0.1;0.6;3024;2016;6096384;4763307;658;4763307;530766;530108;4763965;397
ISIC_0014623;400;3;3;100.0;0.6;2592;1936;5018112;1008929;1100402;1008929;1937167;836765;2109331;465
ISIC_0012547;100;4;3;0.1;0.6;4288;2848;12212224;0;572681;0;572681;0;572681;117
ISIC_0013128;250;3;3;1.0;0.6;3872;2592;10036224;5441678;0;5441678;470897;470897;5441678;283
ISIC_0013128;200;4;1;0.01;0.6;3872;2592;10036224;5625984;0;5625984;470897;470897;5625984;226
ISIC_0013082;100;1;1;0.01;0.6;3872;2592;10036224;3526908;0;3526908;254836;254836;3526908;61
ISIC_0014428;100;2;1;100.0;0.6;4288;2848;12212224;2634284;534;2634284;525860;525326;2634818;80
ISIC_0013082;450;3;2;0.01;0.6;3872;2592;10036224;1651078;0;1651078;254836;254836;1651078;516
ISIC_0013128;450;2;3;100.0;0.6;3872;2592;10036224;4668655;0;4668655;470897;470897;4668655;510
ISIC_0014428;200;3;2;0.01;0.6;4288;2848;12212224;1562670;0;1562670;525860;525860;1562670;216
ISIC_0012547;150;2;2;1.0;0.6;4288;2848;12212224;11557921;0;11557921;572681;572681;11557921;143
ISIC_0008524;150;2;2;0.01;0.6;4288;2848;12212224;5340909;0;5340909;323767;323767;5340909;141
ISIC_0008524;300;3;2;0.1;0.6;4288;2848;12212224;4274501;5021;4274501;323767;318746;4279522;337
ISIC_0014428;100;2;3;0.1;0.6;4288;2848;12212224;2314704;7;2314704;525860;525853;2314711;87
ISIC_0013082;350;4;2;10.0;0.6;3872;2592;10036224;1955525;0;1955525;254836;254836;1955525;414
ISIC_0013188;300;3;3;0.01;0.6;3008;2000;6016000;3688794;0;3688794;92544;92544;3688794;341
ISIC_0003657;100;4;1;1.0;0.6;3024;2016;6096384;2311295;353;2311295;340261;339908;2311648;108
ISIC_0014428;100;4;3;1.0;0.6;4288;2848;12212224;2245522;8940;2245522;525860;516920;2254462;118
ISIC_0014712;400;1;3;10.0;0.6;6621;4422;29278062;1404237;16479721;1404237;24292916;7813195;17883958;434
ISIC_0007332;200;3;3;100.0;0.6;3024;2016;6096384;5168801;0;5168801;530766;530766;5168801;225
ISIC_0014623;450;1;1;0.1;0.6;2592;1936;5018112;1116551;1034146;1116551;1937167;903021;2150697;482
ISIC_0003657;50;2;1;0.01;0.6;3024;2016;6096384;3557164;0;3557164;340261;340261;3557164;16
ISIC_0014712;300;3;2;0.1;0.6;6621;4422;29278062;1367871;17676382;1367871;24292916;6616534;19044253;337
ISIC_0003657;300;3;3;100.0;0.6;3024;2016;6096384;1602828;2337;1602828;340261;337924;1605165;345
ISIC_0013188;200;4;3;0.01;0.6;3008;2000;6016000;4061302;302;4061302;92544;92242;4061604;236
ISIC_0013082;400;4;3;0.1;0.6;3872;2592;10036224;1636761;934;1636761;254836;253902;1637695;477
ISIC_0013082;250;4;3;1.0;0.6;3872;2592;10036224;2106235;0;2106235;254836;254836;2106235;298
ISIC_0008524;150;4;1;100.0;0.6;4288;2848;12212224;4172718;5649;4172718;323767;318118;4178367;170
ISIC_0013128;200;1;1;0.1;0.6;3872;2592;10036224;5801912;0;5801912;470897;470897;5801912;182
ISIC_0003657;250;3;2;0.01;0.6;3024;2016;6096384;1759738;11531;1759738;340261;328730;1771269;276
ISIC_0008524;100;3;1;10.0;0.6;4288;2848;12212224;5531245;4777;5531245;323767;318990;5536022;94
ISIC_0003657;50;4;3;1.0;0.6;3024;2016;6096384;2177500;56;2177500;340261;340205;2177556;58
ISIC_0014712;200;2;2;0.01;0.6;6621;4422;29278062;1650741;16045715;1650741;24292916;8247201;17696456;201
ISIC_0008524;100;1;3;0.01;0.6;4288;2848;12212224;6161491;3666;6161491;323767;320101;6165157;71
ISIC_0014623;450;4;3;1.0;0.6;2592;1936;5018112;875643;1217536;875643;1937167;719631;2093179;538
ISIC_0013128;450;2;3;10.0;0.6;3872;2592;10036224;4668655;0;4668655;470897;470897;4668655;509
ISIC_0013128;150;1;3;10.0;0.6;3872;2592;10036224;5945837;0;5945837;470897;470897;5945837;134
ISIC_0014712;300;1;3;1.0;0.6;6621;4422;29278062;1326291;15822083;1326291;24292916;8470833;17148374;313
ISIC_0013082;100;4;3;1.0;0.6;3872;2592;10036224;2997899;0;2997899;254836;254836;2997899;118
ISIC_0013128;100;4;2;0.1;0.6;3872;2592;10036224;6552441;0;6552441;470897;470897;6552441;112
ISIC_0007332;400;3;2;10.0;0.6;3024;2016;6096384;4811876;0;4811876;530766;530766;4811876;459
ISIC_0008524;400;2;2;100.0;0.6;4288;2848;12212224;3997012;13085;3997012;323767;310682;4010097;445
ISIC_0007332;100;2;1;100.0;0.6;3024;2016;6096384;0;530766;0;530766;0;530766;80
ISIC_0003657;300;4;1;0.01;0.6;3024;2016;6096384;1700163;1126;1700163;340261;339135;1701289;346
ISIC_0014712;250;4;1;100.0;0.6;6621;4422;29278062;1784643;17882220;1784643;24292916;6410696;19666863;290
ISIC_0014623;150;4;3;0.1;0.6;2592;1936;5018112;1317230;909787;1317230;1937167;1027380;2227017;177
ISIC_0008524;50;1;2;10.0;0.6;4288;2848;12212224;6157049;12082;6157049;323767;311685;6169131;9
ISIC_0007332;150;1;2;1.0;0.6;3024;2016;6096384;5525218;0;5525218;530766;530766;5525218;128
ISIC_0013128;400;4;3;1.0;0.6;3872;2592;10036224;4483068;0;4483068;470897;470897;4483068;478
ISIC_0014623;50;2;3;100.0;0.6;2592;1936;5018112;2054610;437309;2054610;1937167;1499858;2491919;30
ISIC_0003657;300;4;3;1.0;0.6;3024;2016;6096384;1540041;3130;1540041;340261;337131;1543171;358
ISIC_0013128;150;2;3;1.0;0.6;3872;2592;10036224;5812949;0;5812949;470897;470897;5812949;148
ISIC_0013082;200;4;1;1.0;0.6;3872;2592;10036224;2087685;564;2087685;254836;254272;2088249;228
ISIC_0014428;50;2;3;100.0;0.6;4288;2848;12212224;2715317;1211;2715317;525860;524649;2716528;30
ISIC_0012547;200;2;2;100.0;0.6;4288;2848;12212224;11253594;0;11253594;572681;572681;11253594;205
ISIC_0008524;200;3;2;1.0;0.6;4288;2848;12212224;4644178;10433;4644178;323767;313334;4654611;218
ISIC_0014428;450;4;1;0.01;0.6;4288;2848;12212224;1099654;0;1099654;525860;525860;1099654;526
ISIC_0008524;300;3;3;0.1;0.6;4288;2848;12212224;4281240;11663;4281240;323767;312104;4292903;342
ISIC_0013128;200;4;1;10.0;0.6;3872;2592;10036224;5464858;0;5464858;470897;470897;5464858;229
ISIC_0007332;300;4;1;1.0;0.6;3024;2016;6096384;5067951;0;5067951;530766;530766;5067951;348
ISIC_0003657;150;4;3;100.0;0.6;3024;2016;6096384;1972509;1986;1972509;340261;338275;1974495;180
ISIC_0013082;150;2;2;0.01;0.6;3872;2592;10036224;2712680;0;2712680;254836;254836;2712680;141
ISIC_0003657;100;1;2;1.0;0.6;3024;2016;6096384;2754880;882;2754880;340261;339379;2755762;68
ISIC_0014712;200;1;1;0.1;0.6;6621;4422;29278062;1528856;15121742;1528856;24292916;9171174;16650598;182
ISIC_0014623;50;2;3;1.0;0.6;2592;1936;5018112;2054585;437160;2054585;1937167;1500007;2491745;28
ISIC_0007332;100;3;1;0.1;0.6;3024;2016;6096384;0;530766;0;530766;0;530766;92
ISIC_0014712;200;1;1;1.0;0.6;6621;4422;29278062;1529684;14862215;1529684;24292916;9430701;16391899;183
ISIC_0014623;400;3;2;100.0;0.6;2592;1936;5018112;1009203;1100183;1009203;1937167;836984;2109386;460
ISIC_0003657;250;2;3;0.1;0.6;3024;2016;6096384;1872916;511;1872916;340261;339750;1873427;267
ISIC_0013082;150;2;1;0.01;0.6;3872;2592;10036224;3022181;0;3022181;254836;254836;3022181;136
ISIC_0013128;200;3;3;10.0;0.6;3872;2592;10036224;5570274;0;5570274;470897;470897;5570274;224
ISIC_0013082;200;4;2;10.0;0.6;3872;2592;10036224;2123912;200;2123912;254836;254636;2124112;234
ISIC_0014428;200;3;3;100.0;0.6;4288;2848;12212224;1500209;999;1500209;525860;524861;1501208;225
ISIC_0008524;100;2;3;1.0;0.6;4288;2848;12212224;5639719;1885;5639719;323767;321882;5641604;88
ISIC_0014712;300;1;3;0.01;0.6;6621;4422;29278062;1348252;16334863;1348252;24292916;7958053;17683115;311
ISIC_0008524;150;3;3;1.0;0.6;4288;2848;12212224;5056260;2840;5056260;323767;320927;5059100;163
ISIC_0013082;450;2;3;1.0;0.6;3872;2592;10036224;1785352;0;1785352;254836;254836;1785352;508
ISIC_0013082;350;4;2;0.1;0.6;3872;2592;10036224;1731641;4403;1731641;254836;250433;1736044;412
ISIC_0013128;50;1;3;100.0;0.6;3872;2592;10036224;6971244;0;6971244;470897;470897;6971244;15
ISIC_0007332;350;4;1;1.0;0.6;3024;2016;6096384;4854796;0;4854796;530766;530766;4854796;408
ISIC_0003657;50;4;2;10.0;0.6;3024;2016;6096384;2078120;72;2078120;340261;340189;2078192;54
ISIC_0013128;450;2;3;0.1;0.6;3872;2592;10036224;4605047;0;4605047;470897;470897;4605047;507
ISIC_0008524;50;1;3;100.0;0.6;4288;2848;12212224;6157200;12029;6157200;323767;311738;6169229;15
ISIC_0007332;450;3;2;10.0;0.6;3024;2016;6096384;4683750;83;4683750;530766;530683;4683833;519
ISIC_0012547;150;2;2;0.01;0.6;4288;2848;12212224;0;572681;0;572681;0;572681;141
ISIC_0007332;250;3;3;0.1;0.6;3024;2016;6096384;5098818;1019;5098818;530766;529747;5099837;282
ISIC_0008524;450;1;3;1.0;0.6;4288;2848;12212224;4029165;14104;4029165;323767;309663;4043269;493
ISIC_0014712;250;1;2;0.1;0.6;6621;4422;29278062;2009614;15416555;2009614;24292916;8876361;17426169;247
ISIC_0014623;350;1;3;1.0;0.6;2592;1936;5018112;1178416;923083;1178416;1937167;1014084;2101499;373
ISIC_0014712;200;2;1;1.0;0.6;6621;4422;29278062;1518671;16464013;1518671;24292916;7828903;17982684;198
ISIC_0012547;50;4;1;0.1;0.6;4288;2848;12212224;0;572681;0;572681;0;572681;47
ISIC_0012547;400;3;2;10.0;0.6;4288;2848;12212224;11191891;61250;11191891;572681;511431;11253141;459
ISIC_0013188;350;2;2;100.0;0.6;3008;2000;6016000;3509675;0;3509675;92544;92544;3509675;385
ISIC_0013082;200;2;1;1.0;0.6;3872;2592;10036224;2086545;474;2086545;254836;254362;2087019;198
ISIC_0013128;200;2;1;0.1;0.6;3872;2592;10036224;5661028;0;5661028;470897;470897;5661028;197
ISIC_0014623;350;4;3;1.0;0.6;2592;1936;5018112;960382;1144136;960382;1937167;793031;2104518;418
ISIC_0012547;200;2;3;10.0;0.6;4288;2848;12212224;11253354;0;11253354;572681;572681;11253354;209
ISIC_0013188;50;1;3;1.0;0.6;3008;2000;6016000;5071205;0;5071205;92544;92544;5071205;13
ISIC_0013188;150;3;3;0.1;0.6;3008;2000;6016000;4482218;0;4482218;92544;92544;4482218;162
ISIC_0013188;450;4;1;0.1;0.6;3008;2000;6016000;3119970;0;3119970;92544;92544;3119970;527
ISIC_0008524;300;2;1;1.0;0.6;4288;2848;12212224;4437996;1311;4437996;323767;322456;4439307;318
ISIC_0013082;300;1;3;10.0;0.6;3872;2592;10036224;2201303;224;2201303;254836;254612;2201527;314
ISIC_0012547;250;2;1;0.01;0.6;4288;2848;12212224;11472181;0;11472181;572681;572681;11472181;256
ISIC_0012547;150;2;3;10.0;0.6;4288;2848;12212224;11558318;0;11558318;572681;572681;11558318;149
ISIC_0013188;300;4;2;10.0;0.6;3008;2000;6016000;3655751;45;3655751;92544;92499;3655796;354
ISIC_0013082;150;1;1;100.0;0.6;3872;2592;10036224;2759697;183;2759697;254836;254653;2759880;125
ISIC_0012547;350;1;2;1.0;0.6;4288;2848;12212224;11289373;36400;11289373;572681;536281;11325773;368
ISIC_0014428;450;2;1;100.0;0.6;4288;2848;12212224;1156198;8163;1156198;525860;517697;1164361;500
ISIC_0012547;250;2;3;10.0;0.6;4288;2848;12212224;11494346;0;11494346;572681;572681;11494346;269
ISIC_0003657;350;3;2;0.01;0.6;3024;2016;6096384;1645695;11676;1645695;340261;328585;1657371;396
ISIC_0013188;50;1;2;10.0;0.6;3008;2000;6016000;5062085;0;5062085;92544;92544;5062085;9
ISIC_0013188;150;4;2;10.0;0.6;3008;2000;6016000;4436995;0;4436995;92544;92544;4436995;174
ISIC_0008524;350;2;2;100.0;0.6;4288;2848;12212224;3998552;277;3998552;323767;323490;3998829;385
ISIC_0007332;150;1;2;100.0;0.6;3024;2016;6096384;5525218;0;5525218;530766;530766;5525218;130
ISIC_0014428;50;4;1;10.0;0.6;4288;2848;12212224;2715633;1211;2715633;525860;524649;2716844;49
ISIC_0014623;50;3;3;100.0;0.6;2592;1936;5018112;2054893;436469;2054893;1937167;1500698;2491362;45
ISIC_0013188;150;1;2;0.1;0.6;3008;2000;6016000;4474425;0;4474425;92544;92544;4474425;127
ISIC_0012547;150;1;2;1.0;0.6;4288;2848;12212224;11557736;0;11557736;572681;572681;11557736;128
ISIC_0014428;150;1;2;10.0;0.6;4288;2848;12212224;2154405;990;2154405;525860;524870;2155395;129
ISIC_0013188;100;3;3;10.0;0.6;3008;2000;6016000;4801197;0;4801197;92544;92544;4801197;104
ISIC_0013082;150;3;2;0.1;0.6;3872;2592;10036224;2848702;290;2848702;254836;254546;2848992;157
ISIC_0003657;150;2;1;1.0;0.6;3024;2016;6096384;2172117;2156;2172117;340261;338105;2174273;138
ISIC_0003657;100;4;3;0.1;0.6;3024;2016;6096384;2469452;82;2469452;340261;340179;2469534;117
ISIC_0012547;350;1;1;100.0;0.6;4288;2848;12212224;11289043;36400;11289043;572681;536281;11325443;365
ISIC_0013082;100;3;1;100.0;0.6;3872;2592;10036224;2998288;0;2998288;254836;254836;2998288;95
ISIC_0014712;250;4;3;0.01;0.6;6621;4422;29278062;1439601;18173552;1439601;24292916;6119364;19613153;296
ISIC_0003657;150;3;1;0.01;0.6;3024;2016;6096384;2253499;0;2253499;340261;340261;2253499;151
ISIC_0014428;350;1;3;0.01;0.6;4288;2848;12212224;984732;4178;984732;525860;521682;988910;371
ISIC_0012547;300;3;3;0.01;0.6;4288;2848;12212224;11424214;63701;11424214;572681;508980;11487915;341
ISIC_0014712;300;2;2;0.1;0.6;6621;4422;29278062;1372248;17278729;1372248;24292916;7014187;18650977;322
ISIC_0013082;200;1;3;0.1;0.6;3872;2592;10036224;2057019;1377;2057019;254836;253459;2058396;192
ISIC_0014428;300;4;3;0.01;0.6;4288;2848;12212224;1084043;5334;1084043;525860;520526;1089377;356
ISIC_0008524;250;2;1;100.0;0.6;4288;2848;12212224;4539290;7441;4539290;323767;316326;4546731;260
ISIC_0013188;200;2;2;1.0;0.6;3008;2000;6016000;4058809;0;4058809;92544;92544;4058809;203
ISIC_0014623;300;4;1;0.01;0.6;2592;1936;5018112;1021568;1099063;1021568;1937167;838104;2120631;346
ISIC_0003657;350;3;1;1.0;0.6;3024;2016;6096384;1614263;2927;1614263;340261;337334;1617190;393
ISIC_0013128;450;1;2;0.1;0.6;3872;2592;10036224;4700940;0;4700940;470897;470897;4700940;487
ISIC_0012547;100;4;1;0.1;0.6;4288;2848;12212224;0;572681;0;572681;0;572681;107
ISIC_0014428;450;1;3;10.0;0.6;4288;2848;12212224;1237543;8163;1237543;525860;517697;1245706;494
ISIC_0012547;250;2;2;100.0;0.6;4288;2848;12212224;11494346;0;11494346;572681;572681;11494346;265
ISIC_0014428;400;1;2;1.0;0.6;4288;2848;12212224;1131827;4469;1131827;525860;521391;1136296;428
ISIC_0014428;350;1;1;0.01;0.6;4288;2848;12212224;1370930;43;1370930;525860;525817;1370973;361
ISIC_0013128;150;4;3;0.01;0.6;3872;2592;10036224;5743004;0;5743004;470897;470897;5743004;176
ISIC_0014712;50;3;3;0.01;0.6;6621;4422;29278062;3421202;10746034;3421202;24292916;13546882;14167236;41
ISIC_0003657;400;2;1;10.0;0.6;3024;2016;6096384;1610025;3890;1610025;340261;336371;1613915;439
ISIC_0013128;200;4;3;10.0;0.6;3872;2592;10036224;5464550;0;5464550;470897;470897;5464550;239
ISIC_0014623;150;3;3;0.01;0.6;2592;1936;5018112;1445313;767044;1445313;1937167;1170123;2212357;161
ISIC_0013128;300;1;2;0.1;0.6;3872;2592;10036224;5105379;0;5105379;470897;470897;5105379;307
ISIC_0007332;400;4;2;0.1;0.6;3024;2016;6096384;4629585;0;4629585;530766;530766;4629585;472
ISIC_0007332;400;1;3;0.1;0.6;3024;2016;6096384;4695743;5626;4695743;530766;525140;4701369;432
ISIC_0013188;50;3;1;0.01;0.6;3008;2000;6016000;5530588;0;5530588;92544;92544;5530588;31
ISIC_0014712;350;2;3;1.0;0.6;6621;4422;29278062;1252947;17087240;1252947;24292916;7205676;18340187;388
ISIC_0012547;200;3;2;1.0;0.6;4288;2848;12212224;11263600;0;11263600;572681;572681;11263600;218
ISIC_0013128;450;4;3;0.1;0.6;3872;2592;10036224;4406779;0;4406779;470897;470897;4406779;537
ISIC_0013082;50;4;2;100.0;0.6;3872;2592;10036224;3808835;0;3808835;254836;254836;3808835;55
ISIC_0014428;300;4;1;10.0;0.6;4288;2848;12212224;1211474;1843;1211474;525860;524017;1213317;349
ISIC_0013082;250;4;3;0.01;0.6;3872;2592;10036224;1862816;11634;1862816;254836;243202;1874450;296
ISIC_0013188;50;4;1;10.0;0.6;3008;2000;6016000;4950972;0;4950972;92544;92544;4950972;49
ISIC_0013188;200;2;3;0.1;0.6;3008;2000;6016000;4042003;0;4042003;92544;92544;4042003;207
ISIC_0014623;350;2;1;0.1;0.6;2592;1936;5018112;1081055;1051722;1081055;1937167;885445;2132777;377
ISIC_0007332;50;1;1;0.01;0.6;3024;2016;6096384;0;530766;0;530766;0;530766;1
ISIC_0013128;100;2;2;100.0;0.6;3872;2592;10036224;6775949;0;6775949;470897;470897;6775949;85
ISIC_0014712;450;1;2;0.1;0.6;6621;4422;29278062;950221;17441369;950221;24292916;6851547;18391590;487
ISIC_0013082;300;2;1;0.1;0.6;3872;2592;10036224;2079779;0;2079779;254836;254836;2079779;317
ISIC_0013188;400;4;3;0.1;0.6;3008;2000;6016000;3163893;0;3163893;92544;92544;3163893;477
ISIC_0013128;50;4;1;0.01;0.6;3872;2592;10036224;7678956;0;7678956;470897;470897;7678956;46
ISIC_0013082;250;1;2;0.1;0.6;3872;2592;10036224;1915724;4216;1915724;254836;250620;1919940;247
ISIC_0014428;350;1;3;10.0;0.6;4288;2848;12212224;1338154;6259;1338154;525860;519601;1344413;374
ISIC_0003657;400;3;3;1.0;0.6;3024;2016;6096384;1539026;4146;1539026;340261;336115;1543172;463
ISIC_0008524;450;3;1;100.0;0.6;4288;2848;12212224;3650389;18436;3650389;323767;305331;3668825;515
ISIC_0013082;100;1;1;1.0;0.6;3872;2592;10036224;3104678;0;3104678;254836;254836;3104678;63
ISIC_0014623;350;2;2;0.01;0.6;2592;1936;5018112;1110590;1044670;1110590;1937167;892497;2155260;381
ISIC_0008524;400;2;2;0.1;0.6;4288;2848;12212224;3885419;3609;3885419;323767;320158;3889028;442
ISIC_0013128;400;2;2;0.01;0.6;3872;2592;10036224;4756414;0;4756414;470897;470897;4756414;441
ISIC_0008524;150;3;1;1.0;0.6;4288;2848;12212224;5055414;2605;5055414;323767;321162;5058019;153
ISIC_0014428;100;4;2;0.1;0.6;4288;2848;12212224;2043126;18;2043126;525860;525842;2043144;112
ISIC_0014623;300;1;3;100.0;0.6;2592;1936;5018112;1226322;956160;1226322;1937167;981007;2182482;315
ISIC_0013188;450;1;3;10.0;0.6;3008;2000;6016000;3139611;0;3139611;92544;92544;3139611;494
ISIC_0013188;350;4;3;0.1;0.6;3008;2000;6016000;3432722;0;3432722;92544;92544;3432722;417
ISIC_0012547;250;1;3;0.1;0.6;4288;2848;12212224;11533421;0;11533421;572681;572681;11533421;252
ISIC_0003657;100;3;3;0.1;0.6;3024;2016;6096384;2606722;62;2606722;340261;340199;2606784;102
ISIC_0003657;350;1;1;1.0;0.6;3024;2016;6096384;1805653;2927;1805653;340261;337334;1808580;363
ISIC_0013188;200;4;2;0.01;0.6;3008;2000;6016000;4084464;458;4084464;92544;92086;4084922;231
ISIC_0014712;50;4;3;1.0;0.6;6621;4422;29278062;2260932;13772594;2260932;24292916;10520322;16033526;58
ISIC_0013082;150;4;1;1.0;0.6;3872;2592;10036224;2689715;2839;2689715;254836;251997;2692554;168
ISIC_0008524;200;1;3;0.01;0.6;4288;2848;12212224;4991394;0;4991394;323767;323767;4991394;191
ISIC_0003657;150;3;3;1.0;0.6;3024;2016;6096384;2052576;2136;2052576;340261;338125;2054712;163
ISIC_0013128;450;1;3;10.0;0.6;3872;2592;10036224;4786514;0;4786514;470897;470897;4786514;494
ISIC_0013082;50;2;1;1.0;0.6;3872;2592;10036224;3805835;0;3805835;254836;254836;3805835;18
ISIC_0012547;400;3;2;1.0;0.6;4288;2848;12212224;11191943;61250;11191943;572681;511431;11253193;458
ISIC_0008524;400;1;3;100.0;0.6;4288;2848;12212224;4134861;13085;4134861;323767;310682;4147946;435
ISIC_0003657;150;4;1;1.0;0.6;3024;2016;6096384;1891545;2149;1891545;340261;338112;1893694;168
ISIC_0003657;400;4;3;0.1;0.6;3024;2016;6096384;1537146;0;1537146;340261;340261;1537146;477
ISIC_0012547;450;2;1;100.0;0.6;4288;2848;12212224;11254268;54450;11254268;572681;518231;11308718;500
ISIC_0014712;200;4;2;10.0;0.6;6621;4422;29278062;1245326;17361311;1245326;24292916;6931605;18606637;234
ISIC_0014428;150;4;2;1.0;0.6;4288;2848;12212224;1821618;3206;1821618;525860;522654;1824824;173
ISIC_0013128;150;4;2;0.1;0.6;3872;2592;10036224;5713220;0;5713220;470897;470897;5713220;172
ISIC_0013128;250;3;1;0.01;0.6;3872;2592;10036224;5575946;0;5575946;470897;470897;5575946;271
ISIC_0012547;400;2;1;10.0;0.6;4288;2848;12212224;11219541;0;11219541;572681;572681;11219541;439
ISIC_0014712;150;2;2;0.1;0.6;6621;4422;29278062;1941965;15402093;1941965;24292916;8890823;17344058;142
ISIC_0012547;200;2;1;1.0;0.6;4288;2848;12212224;11263279;0;11263279;572681;572681;11263279;198
ISIC_0012547;200;2;1;10.0;0.6;4288;2848;12212224;11253101;0;11253101;572681;572681;11253101;199
ISIC_0013128;300;3;3;1.0;0.6;3872;2592;10036224;5070946;55;5070946;470897;470842;5071001;343
ISIC_0007332;250;1;2;0.01;0.6;3024;2016;6096384;5078861;0;5078861;530766;530766;5078861;246
ISIC_0014712;50;4;2;0.1;0.6;6621;4422;29278062;2254154;13805573;2254154;24292916;10487343;16059727;52
ISIC_0013188;300;2;1;10.0;0.6;3008;2000;6016000;3695991;45;3695991;92544;92499;3696036;319
ISIC_0014712;350;1;1;100.0;0.6;6621;4422;29278062;1259768;15588932;1259768;24292916;8703984;16848700;365
ISIC_0014712;250;2;2;0.1;0.6;6621;4422;29278062;1788046;16681508;1788046;24292916;7611408;18469554;262
ISIC_0014623;50;4;2;1.0;0.6;2592;1936;5018112;2054261;437102;2054261;1937167;1500065;2491363;53
ISIC_0014428;350;2;3;100.0;0.6;4288;2848;12212224;1232873;6259;1232873;525860;519601;1239132;390
ISIC_0012547;200;3;2;10.0;0.6;4288;2848;12212224;11253313;0;11253313;572681;572681;11253313;219
ISIC_0013188;400;3;2;10.0;0.6;3008;2000;6016000;3249918;0;3249918;92544;92544;3249918;459
ISIC_0013128;450;3;1;10.0;0.6;3872;2592;10036224;4620853;0;4620853;470897;470897;4620853;514
ISIC_0008524;50;2;3;100.0;0.6;4288;2848;12212224;6157198;12029;6157198;323767;311738;6169227;30
ISIC_0008524;300;4;1;1.0;0.6;4288;2848;12212224;3703968;993;3703968;323767;322774;3704961;348
ISIC_0013188;200;2;3;1.0;0.6;3008;2000;6016000;4062418;0;4062418;92544;92544;4062418;208
ISIC_0007332;300;4;2;0.1;0.6;3024;2016;6096384;5000984;0;5000984;530766;530766;5000984;352
ISIC_0013128;350;3;2;10.0;0.6;3872;2592;10036224;4845094;0;4845094;470897;470897;4845094;399
ISIC_0013082;200;1;3;0.01;0.6;3872;2592;10036224;2167847;13348;2167847;254836;241488;2181195;191
ISIC_0007332;300;1;3;0.01;0.6;3024;2016;6096384;4997474;0;4997474;530766;530766;4997474;311
ISIC_0013188;250;4;3;0.1;0.6;3008;2000;6016000;3747198;0;3747198;92544;92544;3747198;297
ISIC_0013082;250;4;2;0.01;0.6;3872;2592;10036224;2113522;0;2113522;254836;254836;2113522;291
ISIC_0012547;50;2;1;1.0;0.6;4288;2848;12212224;10803430;0;10803430;572681;572681;10803430;18
ISIC_0008524;450;2;1;0.1;0.6;4288;2848;12212224;3913226;8745;3913226;323767;315022;3921971;497
ISIC_0014428;250;1;2;10.0;0.6;4288;2848;12212224;1469675;4628;1469675;525860;521232;1474303;249
ISIC_0014712;450;4;2;0.01;0.6;6621;4422;29278062;1009702;19099070;1009702;24292916;5193846;20108772;531
ISIC_0012547;300;4;1;0.1;0.6;4288;2848;12212224;11342482;131555;11342482;572681;441126;11474037;347
ISIC_0013128;50;2;1;1.0;0.6;3872;2592;10036224;6961213;0;6961213;470897;470897;6961213;18
ISIC_0012547;200;2;2;0.01;0.6;4288;2848;12212224;11544905;0;11544905;572681;572681;11544905;201
ISIC_0014623;350;4;1;0.01;0.6;2592;1936;5018112;973793;1134783;973793;1937167;802384;2108576;406
ISIC_0014712;350;3;1;10.0;0.6;6621;4422;29278062;1248104;17167499;1248104;24292916;7125417;18415603;394
ISIC_0008524;450;1;3;0.01;0.6;4288;2848;12212224;4165974;2920;4165974;323767;320847;4168894;491
ISIC_0014712;400;1;1;100.0;0.6;6621;4422;29278062;1404245;16479696;1404245;24292916;7813220;17883941;425
ISIC_0012547;450;1;2;1.0;0.6;4288;2848;12212224;11280903;0;11280903;572681;572681;11280903;488
ISIC_0008524;350;2;1;10.0;0.6;4288;2848;12212224;3998364;277;3998364;323767;323490;3998641;379
ISIC_0007332;150;3;3;10.0;0.6;3024;2016;6096384;5525218;0;5525218;530766;530766;5525218;164
ISIC_0007332;200;2;1;10.0;0.6;3024;2016;6096384;5168994;0;5168994;530766;530766;5168994;199
ISIC_0007332;100;3;1;0.01;0.6;3024;2016;6096384;0;530766;0;530766;0;530766;91
ISIC_0008524;200;1;1;10.0;0.6;4288;2848;12212224;4726771;11825;4726771;323767;311942;4738596;184
ISIC_0014712;350;3;2;1.0;0.6;6621;4422;29278062;1248100;17167018;1248100;24292916;7125898;18415118;398
ISIC_0013082;200;4;2;0.01;0.6;3872;2592;10036224;2459458;6075;2459458;254836;248761;2465533;231
ISIC_0003657;100;3;3;1.0;0.6;3024;2016;6096384;2440654;347;2440654;340261;339914;2441001;103
ISIC_0008524;400;4;3;10.0;0.6;4288;2848;12212224;3131125;13085;3131125;323767;310682;3144210;479
ISIC_0013082;350;4;3;0.01;0.6;3872;2592;10036224;1462838;15068;1462838;254836;239768;1477906;416
ISIC_0013128;150;3;3;10.0;0.6;3872;2592;10036224;5745378;0;5745378;470897;470897;5745378;164
ISIC_0008524;50;2;3;0.01;0.6;4288;2848;12212224;7602530;0;7602530;323767;323767;7602530;26
ISIC_0014712;100;2;3;0.01;0.6;6621;4422;29278062;3084583;12735573;3084583;24292916;11557343;15820156;86
ISIC_0007332;300;2;1;0.01;0.6;3024;2016;6096384;5006254;1;5006254;530766;530765;5006255;316
ISIC_0014712;250;2;2;10.0;0.6;6621;4422;29278062;1784886;16828996;1784886;24292916;7463920;18613882;264
ISIC_0013128;400;1;2;0.01;0.6;3872;2592;10036224;4909182;0;4909182;470897;470897;4909182;426
ISIC_0003657;350;2;2;100.0;0.6;3024;2016;6096384;1646851;2927;1646851;340261;337334;1649778;385
ISIC_0014428;400;4;3;1.0;0.6;4288;2848;12212224;984378;4749;984378;525860;521111;989127;478
ISIC_0008524;350;1;3;10.0;0.6;4288;2848;12212224;4242441;277;4242441;323767;323490;4242718;374
ISIC_0007332;400;1;2;100.0;0.6;3024;2016;6096384;4811876;0;4811876;530766;530766;4811876;430
ISIC_0008524;200;1;3;0.1;0.6;4288;2848;12212224;4909306;3226;4909306;323767;320541;4912532;192
ISIC_0008524;350;3;3;1.0;0.6;4288;2848;12212224;4102796;5091;4102796;323767;318676;4107887;403
ISIC_0013082;300;4;2;1.0;0.6;3872;2592;10036224;2130852;1606;2130852;254836;253230;2132458;353
ISIC_0014712;400;3;2;100.0;0.6;6621;4422;29278062;1239206;17659362;1239206;24292916;6633554;18898568;460
ISIC_0013082;300;3;3;100.0;0.6;3872;2592;10036224;2201192;224;2201192;254836;254612;2201416;345
ISIC_0003657;350;3;1;0.1;0.6;3024;2016;6096384;1708959;0;1708959;340261;340261;1708959;392
ISIC_0014712;400;4;2;0.01;0.6;6621;4422;29278062;1034412;18514961;1034412;24292916;5777955;19549373;471
ISIC_0014623;250;4;2;1.0;0.6;2592;1936;5018112;1086375;1046878;1086375;1937167;890289;2133253;293
ISIC_0014623;150;3;1;10.0;0.6;2592;1936;5018112;1340802;887073;1340802;1937167;1050094;2227875;154
ISIC_0013128;350;4;1;100.0;0.6;3872;2592;10036224;4753794;0;4753794;470897;470897;4753794;410
ISIC_0013128;350;4;2;0.01;0.6;3872;2592;10036224;4827713;0;4827713;470897;470897;4827713;411
ISIC_0012547;350;4;3;0.1;0.6;4288;2848;12212224;11236729;111956;11236729;572681;460725;11348685;417
ISIC_0012547;300;1;2;1.0;0.6;4288;2848;12212224;11387833;0;11387833;572681;572681;11387833;308
ISIC_0008524;50;3;3;10.0;0.6;4288;2848;12212224;6380710;12095;6380710;323767;311672;6392805;44
ISIC_0014428;350;4;2;100.0;0.6;4288;2848;12212224;1197904;6259;1197904;525860;519601;1204163;415
ISIC_0008524;350;2;3;0.01;0.6;4288;2848;12212224;4108459;5171;4108459;323767;318596;4113630;386
ISIC_0014428;300;1;2;0.1;0.6;4288;2848;12212224;1289482;935;1289482;525860;524925;1290417;307
ISIC_0003657;100;3;3;100.0;0.6;3024;2016;6096384;2439669;30;2439669;340261;340231;2439699;105
ISIC_0007332;250;1;2;10.0;0.6;3024;2016;6096384;5174623;895;5174623;530766;529871;5175518;249
ISIC_0003657;450;1;2;10.0;0.6;3024;2016;6096384;1694938;1807;1694938;340261;338454;1696745;489
ISIC_0013128;400;1;1;100.0;0.6;3872;2592;10036224;4736367;0;4736367;470897;470897;4736367;425
ISIC_0003657;50;2;2;10.0;0.6;3024;2016;6096384;2534572;72;2534572;340261;340189;2534644;24
ISIC_0014428;200;4;3;0.1;0.6;4288;2848;12212224;1508722;0;1508722;525860;525860;1508722;237
ISIC_0003657;400;1;3;10.0;0.6;3024;2016;6096384;1781089;3890;1781089;340261;336371;1784979;434
ISIC_0003657;400;3;3;0.01;0.6;3024;2016;6096384;1544872;9012;1544872;340261;331249;1553884;461
ISIC_0013188;250;4;2;1.0;0.6;3008;2000;6016000;3797292;0;3797292;92544;92544;3797292;293
ISIC_0014712;50;1;3;0.1;0.6;6621;4422;29278062;2822085;10428731;2822085;24292916;13864185;13250816;12
ISIC_0014712;400;3;3;0.1;0.6;6621;4422;29278062;1205882;17897811;1205882;24292916;6395105;19103693;462
ISIC_0008524;300;1;3;10.0;0.6;4288;2848;12212224;4439702;4070;4439702;323767;319697;4443772;314
ISIC_0014623;100;1;1;1.0;0.6;2592;1936;5018112;1676290;580762;1676290;1937167;1356405;2257052;63
ISIC_0012547;200;1;3;100.0;0.6;4288;2848;12212224;11252787;0;11252787;572681;572681;11252787;195
ISIC_0003657;400;3;2;10.0;0.6;3024;2016;6096384;1539142;3890;1539142;340261;336371;1543032;459
ISIC_0007332;150;4;3;1.0;0.6;3024;2016;6096384;5525218;0;5525218;530766;530766;5525218;178
ISIC_0014428;50;3;1;0.01;0.6;4288;2848;12212224;2998534;0;2998534;525860;525860;2998534;31
ISIC_0012547;350;4;2;100.0;0.6;4288;2848;12212224;11254071;106338;11254071;572681;466343;11360409;415
ISIC_0013188;150;4;3;10.0;0.6;3008;2000;6016000;4437179;0;4437179;92544;92544;4437179;179
ISIC_0013082;50;4;3;0.1;0.6;3872;2592;10036224;3243046;10299;3243046;254836;244537;3253345;57
ISIC_0014712;50;2;1;1.0;0.6;6621;4422;29278062;2466018;12862332;2466018;24292916;11430584;15328350;18
ISIC_0014712;300;4;2;10.0;0.6;6621;4422;29278062;1314378;18365159;1314378;24292916;5927757;19679537;354
ISIC_0012547;300;4;3;0.01;0.6;4288;2848;12212224;11435502;0;11435502;572681;572681;11435502;356
ISIC_0014712;50;1;1;100.0;0.6;6621;4422;29278062;2825624;10386461;2825624;24292916;13906455;13212085;5
ISIC_0014428;400;1;3;1.0;0.6;4288;2848;12212224;1164436;4471;1164436;525860;521389;1168907;433
ISIC_0013128;300;3;2;0.01;0.6;3872;2592;10036224;5067236;0;5067236;470897;470897;5067236;336
ISIC_0013188;250;4;1;0.1;0.6;3008;2000;6016000;3648207;0;3648207;92544;92544;3648207;287
ISIC_0014623;100;2;1;100.0;0.6;2592;1936;5018112;1621541;624355;1621541;1937167;1312812;2245896;80
ISIC_0007332;100;1;1;10.0;0.6;3024;2016;6096384;0;530766;0;530766;0;530766;64
ISIC_0008524;250;4;3;0.01;0.6;4288;2848;12212224;3863213;6116;3863213;323767;317651;3869329;296
ISIC_0013188;200;4;3;0.1;0.6;3008;2000;6016000;4051677;0;4051677;92544;92544;4051677;237
ISIC_0014623;300;2;3;0.01;0.6;2592;1936;5018112;1077417;1083498;1077417;1937167;853669;2160915;326
ISIC_0014712;250;2;1;0.01;0.6;6621;4422;29278062;1768090;16478757;1768090;24292916;7814159;18246847;256
ISIC_0013082;450;1;2;10.0;0.6;3872;2592;10036224;1722793;1608;1722793;254836;253228;1724401;489
ISIC_0003657;50;3;1;0.1;0.6;3024;2016;6096384;2950106;5338;2950106;340261;334923;2955444;32
ISIC_0014712;150;1;3;10.0;0.6;6621;4422;29278062;2009579;13809811;2009579;24292916;10483105;15819390;134
ISIC_0013188;400;4;1;1.0;0.6;3008;2000;6016000;3234539;0;3234539;92544;92544;3234539;468
ISIC_0014623;400;3;1;1.0;0.6;2592;1936;5018112;1009804;1099750;1009804;1937167;837417;2109554;453
ISIC_0013128;300;2;1;0.01;0.6;3872;2592;10036224;5108718;0;5108718;470897;470897;5108718;316
ISIC_0013082;100;1;2;0.1;0.6;3872;2592;10036224;2959827;4747;2959827;254836;250089;2964574;67
ISIC_0012547;450;1;3;100.0;0.6;4288;2848;12212224;11281493;0;11281493;572681;572681;11281493;495
ISIC_0007332;400;4;3;0.01;0.6;3024;2016;6096384;4634787;10080;4634787;530766;520686;4644867;476
ISIC_0007332;250;2;1;0.1;0.6;3024;2016;6096384;5128533;377;5128533;530766;530389;5128910;257
ISIC_0003657;450;1;2;0.01;0.6;3024;2016;6096384;1770198;8579;1770198;340261;331682;1778777;486
ISIC_0014623;250;2;1;1.0;0.6;2592;1936;5018112;1266532;966537;1266532;1937167;970630;2233069;258
ISIC_0014712;250;2;1;100.0;0.6;6621;4422;29278062;1784643;16829013;1784643;24292916;7463903;18613656;260
ISIC_0012547;100;2;2;0.01;0.6;4288;2848;12212224;0;572681;0;572681;0;572681;81
ISIC_0014623;400;2;2;100.0;0.6;2592;1936;5018112;1079235;1079388;1079235;1937167;857779;2158623;445
ISIC_0003657;450;3;2;1.0;0.6;3024;2016;6096384;1412065;1871;1412065;340261;338390;1413936;518
ISIC_0012547;350;3;2;10.0;0.6;4288;2848;12212224;11254071;71369;11254071;572681;501312;11325440;399
ISIC_0012547;200;3;3;0.01;0.6;4288;2848;12212224;11554723;0;11554723;572681;572681;11554723;221
ISIC_0014428;150;2;2;0.1;0.6;4288;2848;12212224;1750302;0;1750302;525860;525860;1750302;142
ISIC_0013128;200;3;3;100.0;0.6;3872;2592;10036224;5570498;0;5570498;470897;470897;5570498;225
ISIC_0013128;300;2;3;0.1;0.6;3872;2592;10036224;5036047;0;5036047;470897;470897;5036047;327
ISIC_0007332;100;1;3;0.01;0.6;3024;2016;6096384;0;530766;0;530766;0;530766;71
ISIC_0013082;450;4;3;100.0;0.6;3872;2592;10036224;1722804;1608;1722804;254836;253228;1724412;540
ISIC_0013188;350;2;3;0.1;0.6;3008;2000;6016000;3392739;0;3392739;92544;92544;3392739;387
ISIC_0003657;50;2;2;0.01;0.6;3024;2016;6096384;3565203;0;3565203;340261;340261;3565203;21
ISIC_0007332;50;4;3;0.1;0.6;3024;2016;6096384;5233825;0;5233825;530766;530766;5233825;57
ISIC_0014712;450;4;1;10.0;0.6;6621;4422;29278062;1058245;19009863;1058245;24292916;5283053;20068108;529
ISIC_0013188;150;2;2;0.01;0.6;3008;2000;6016000;4541692;0;4541692;92544;92544;4541692;141
ISIC_0014712;100;1;2;1.0;0.6;6621;4422;29278062;3652279;10958912;3652279;24292916;13334004;14611191;68
ISIC_0012547;400;2;3;100.0;0.6;4288;2848;12212224;11219541;0;11219541;572681;572681;11219541;450
ISIC_0014712;100;2;1;0.1;0.6;6621;4422;29278062;3197754;12347045;3197754;24292916;11945871;15544799;77
ISIC_0003657;450;4;1;0.01;0.6;3024;2016;6096384;1537694;0;1537694;340261;340261;1537694;526
ISIC_0003657;400;3;1;1.0;0.6;3024;2016;6096384;1539238;4152;1539238;340261;336109;1543390;453
ISIC_0014623;300;2;1;0.01;0.6;2592;1936;5018112;1132257;1002070;1132257;1937167;935097;2134327;316
ISIC_0013082;450;2;3;0.01;0.6;3872;2592;10036224;1426546;12380;1426546;254836;242456;1438926;506
ISIC_0014428;350;1;1;10.0;0.6;4288;2848;12212224;1338154;6259;1338154;525860;519601;1344413;364
ISIC_0014428;350;2;3;0.1;0.6;4288;2848;12212224;1054438;0;1054438;525860;525860;1054438;387
ISIC_0014623;200;4;2;10.0;0.6;2592;1936;5018112;1160633;976776;1160633;1937167;960391;2137409;234
ISIC_0013188;350;2;1;0.01;0.6;3008;2000;6016000;3612506;0;3612506;92544;92544;3612506;376
ISIC_0008524;50;2;2;1.0;0.6;4288;2848;12212224;6143579;13827;6143579;323767;309940;6157406;23
ISIC_0013082;100;2;1;1.0;0.6;3872;2592;10036224;2998100;0;2998100;254836;254836;2998100;78
ISIC_0013128;450;2;2;0.01;0.6;3872;2592;10036224;4825760;0;4825760;470897;470897;4825760;501
ISIC_0014712;350;1;3;10.0;0.6;6621;4422;29278062;1260462;15587978;1260462;24292916;8704938;16848440;374
ISIC_0014712;50;3;2;1.0;0.6;6621;4422;29278062;2466014;12862359;2466014;24292916;11430557;15328373;38
ISIC_0013188;50;4;1;1.0;0.6;3008;2000;6016000;4947132;0;4947132;92544;92544;4947132;48
ISIC_0013082;150;1;3;10.0;0.6;3872;2592;10036224;2759695;183;2759695;254836;254653;2759878;134
ISIC_0013082;150;2;3;0.1;0.6;3872;2592;10036224;2788006;54;2788006;254836;254782;2788060;147
ISIC_0014712;200;2;1;0.01;0.6;6621;4422;29278062;1641694;16046321;1641694;24292916;8246595;17688015;196
ISIC_0013082;250;2;2;0.01;0.6;3872;2592;10036224;1962145;6245;1962145;254836;248591;1968390;261
ISIC_0014428;100;2;3;10.0;0.6;4288;2848;12212224;2634487;538;2634487;525860;525322;2635025;89
ISIC_0013128;350;2;3;0.1;0.6;3872;2592;10036224;4973819;0;4973819;470897;470897;4973819;387
ISIC_0013128;100;2;3;100.0;0.6;3872;2592;10036224;6775957;0;6775957;470897;470897;6775957;90
ISIC_0013128;450;4;1;0.1;0.6;3872;2592;10036224;4453100;0;4453100;470897;470897;4453100;527
ISIC_0014712;400;2;2;100.0;0.6;6621;4422;29278062;1315899;17585909;1315899;24292916;6707007;18901808;445
ISIC_0014712;450;2;3;10.0;0.6;6621;4422;29278062;1061978;18096632;1061978;24292916;6196284;19158610;509
ISIC_0014712;250;1;2;1.0;0.6;6621;4422;29278062;2006496;15386499;2006496;24292916;8906417;17392995;248
ISIC_0014623;100;1;3;10.0;0.6;2592;1936;5018112;1634192;581048;1634192;1937167;1356119;2215240;74
ISIC_0014712;400;3;1;0.01;0.6;6621;4422;29278062;1216851;17324598;1216851;24292916;6968318;18541449;451
ISIC_0003657;150;4;3;0.1;0.6;3024;2016;6096384;2112974;1316;2112974;340261;338945;2114290;177
ISIC_0014712;150;2;3;1.0;0.6;6621;4422;29278062;1999260;15165274;1999260;24292916;9127642;17164534;148
ISIC_0007332;150;2;3;0.1;0.6;3024;2016;6096384;5482358;0;5482358;530766;530766;5482358;147
ISIC_0013188;300;2;1;1.0;0.6;3008;2000;6016000;3695932;30;3695932;92544;92514;3695962;318
ISIC_0014623;200;4;1;100.0;0.6;2592;1936;5018112;1160530;976779;1160530;1937167;960388;2137309;230
ISIC_0014428;50;3;1;1.0;0.6;4288;2848;12212224;3157371;1647;3157371;525860;524213;3159018;33
ISIC_0014623;250;2;2;0.1;0.6;2592;1936;5018112;1240424;987914;1240424;1937167;949253;2228338;262
ISIC_0014712;100;2;1;1.0;0.6;6621;4422;29278062;3327071;12127086;3327071;24292916;12165830;15454157;78
ISIC_0013128;300;1;1;0.1;0.6;3872;2592;10036224;5137005;0;5137005;470897;470897;5137005;302
ISIC_0012547;100;2;1;100.0;0.6;4288;2848;12212224;0;572681;0;572681;0;572681;80
ISIC_0014623;400;2;1;1.0;0.6;2592;1936;5018112;1079501;1079268;1079501;1937167;857899;2158769;438
ISIC_0008524;400;4;3;1.0;0.6;4288;2848;12212224;3146788;4036;3146788;323767;319731;3150824;478
ISIC_0013128;300;4;3;10.0;0.6;3872;2592;10036224;4966195;39;4966195;470897;470858;4966234;359
ISIC_0013082;100;2;1;0.1;0.6;3872;2592;10036224;2989234;0;2989234;254836;254836;2989234;77
ISIC_0007332;100;4;2;100.0;0.6;3024;2016;6096384;0;530766;0;530766;0;530766;115
ISIC_0013128;150;4;2;10.0;0.6;3872;2592;10036224;5678272;0;5678272;470897;470897;5678272;174
ISIC_0013082;350;3;1;0.01;0.6;3872;2592;10036224;1940213;0;1940213;254836;254836;1940213;391
ISIC_0003657;450;3;3;1.0;0.6;3024;2016;6096384;1411956;1871;1411956;340261;338390;1413827;523
ISIC_0014623;350;3;1;0.1;0.6;2592;1936;5018112;1010055;1060584;1010055;1937167;876583;2070639;392
ISIC_0012547;150;3;2;10.0;0.6;4288;2848;12212224;11558318;0;11558318;572681;572681;11558318;159
ISIC_0014623;50;4;1;1.0;0.6;2592;1936;5018112;2054413;436860;2054413;1937167;1500307;2491273;48
ISIC_0008524;450;1;1;0.01;0.6;4288;2848;12212224;4183307;2514;4183307;323767;321253;4185821;481
ISIC_0003657;400;3;1;100.0;0.6;3024;2016;6096384;1539116;3890;1539116;340261;336371;1543006;455
ISIC_0012547;100;2;2;10.0;0.6;4288;2848;12212224;0;572681;0;572681;0;572681;84
ISIC_0013082;100;4;2;0.01;0.6;3872;2592;10036224;3267760;17475;3267760;254836;237361;3285235;111
ISIC_0013128;450;1;1;10.0;0.6;3872;2592;10036224;4786516;0;4786516;470897;470897;4786516;484
ISIC_0003657;200;2;1;1.0;0.6;3024;2016;6096384;1908097;372;1908097;340261;339889;1908469;198
ISIC_0014712;400;1;2;1.0;0.6;6621;4422;29278062;1404224;16479098;1404224;24292916;7813818;17883322;428
ISIC_0012547;200;1;1;10.0;0.6;4288;2848;12212224;11253148;0;11253148;572681;572681;11253148;184
ISIC_0008524;150;2;2;10.0;0.6;4288;2848;12212224;4993804;5649;4993804;323767;318118;4999453;144
ISIC_0014623;50;2;2;0.1;0.6;2592;1936;5018112;2045486;450169;2045486;1937167;1486998;2495655;22
ISIC_0014428;50;3;1;10.0;0.6;4288;2848;12212224;2715633;1211;2715633;525860;524649;2716844;34
ISIC_0007332;300;2;2;10.0;0.6;3024;2016;6096384;5087996;0;5087996;530766;530766;5087996;324
ISIC_0013188;350;2;3;1.0;0.6;3008;2000;6016000;3526846;0;3526846;92544;92544;3526846;388
ISIC_0012547;200;2;1;0.01;0.6;4288;2848;12212224;11542091;0;11542091;572681;572681;11542091;196
ISIC_0003657;350;4;3;10.0;0.6;3024;2016;6096384;1523821;2927;1523821;340261;337334;1526748;419
ISIC_0012547;150;3;1;10.0;0.6;4288;2848;12212224;11558318;0;11558318;572681;572681;11558318;154
ISIC_0014428;100;1;3;1.0;0.6;4288;2848;12212224;2629618;89;2629618;525860;525771;2629707;73
ISIC_0014623;250;1;1;1.0;0.6;2592;1936;5018112;1388684;891048;1388684;1937167;1046119;2279732;243
ISIC_0013128;350;3;3;0.01;0.6;3872;2592;10036224;4821240;0;4821240;470897;470897;4821240;401
ISIC_0008524;250;3;3;100.0;0.6;4288;2848;12212224;4328366;7441;4328366;323767;316326;4335807;285
ISIC_0007332;450;4;2;0.01;0.6;3024;2016;6096384;4550212;0;4550212;530766;530766;4550212;531
ISIC_0014428;150;4;1;0.01;0.6;4288;2848;12212224;1865455;0;1865455;525860;525860;1865455;166
ISIC_0013188;200;2;2;100.0;0.6;3008;2000;6016000;4007524;0;4007524;92544;92544;4007524;205
ISIC_0014712;200;4;3;100.0;0.6;6621;4422;29278062;1245326;17361312;1245326;24292916;6931604;18606638;240
ISIC_0014428;50;2;3;0.01;0.6;4288;2848;12212224;3136771;7119;3136771;525860;518741;3143890;26
ISIC_0008524;450;3;3;100.0;0.6;4288;2848;12212224;3650403;18436;3650403;323767;305331;3668839;525
ISIC_0007332;150;4;1;100.0;0.6;3024;2016;6096384;5525218;0;5525218;530766;530766;5525218;170
ISIC_0013128;350;3;3;1.0;0.6;3872;2592;10036224;4845718;0;4845718;470897;470897;4845718;403
ISIC_0013082;150;4;3;1.0;0.6;3872;2592;10036224;2689782;2836;2689782;254836;252000;2692618;178
ISIC_0013082;350;1;3;0.1;0.6;3872;2592;10036224;1625644;0;1625644;254836;254836;1625644;372
ISIC_0014428;200;3;2;10.0;0.6;4288;2848;12212224;1500193;999;1500193;525860;524861;1501192;219
ISIC_0007332;100;3;3;10.0;0.6;3024;2016;6096384;0;530766;0;530766;0;530766;104
ISIC_0007332;150;3;2;0.1;0.6;3024;2016;6096384;5478835;0;5478835;530766;530766;5478835;157
ISIC_0013128;400;2;3;1.0;0.6;3872;2592;10036224;4632793;0;4632793;470897;470897;4632793;448
ISIC_0013082;150;1;1;10.0;0.6;3872;2592;10036224;2759695;183;2759695;254836;254653;2759878;124
ISIC_0014623;150;4;3;10.0;0.6;2592;1936;5018112;1336727;886998;1336727;1937167;1050169;2223725;179
ISIC_0012547;50;4;2;10.0;0.6;4288;2848;12212224;10807575;0;10807575;572681;572681;10807575;54
ISIC_0014623;300;3;3;0.01;0.6;2592;1936;5018112;1068094;1076570;1068094;1937167;860597;2144664;341
ISIC_0014623;150;2;2;0.01;0.6;2592;1936;5018112;1601289;686228;1601289;1937167;1250939;2287517;141
ISIC_0014623;300;4;3;100.0;0.6;2592;1936;5018112;1029987;1128003;1029987;1937167;809164;2157990;360
ISIC_0013082;150;4;2;0.1;0.6;3872;2592;10036224;2848516;325;2848516;254836;254511;2848841;172
ISIC_0014623;400;4;3;100.0;0.6;2592;1936;5018112;976416;1143192;976416;1937167;793975;2119608;480
ISIC_0014428;350;4;1;0.1;0.6;4288;2848;12212224;948946;0;948946;525860;525860;948946;407
ISIC_0013082;250;1;1;100.0;0.6;3872;2592;10036224;2106230;0;2106230;254836;254836;2106230;245
ISIC_0013128;350;2;1;100.0;0.6;3872;2592;10036224;4996169;0;4996169;470897;470897;4996169;380
ISIC_0008524;400;2;1;0.1;0.6;4288;2848;12212224;3908845;3677;3908845;323767;320090;3912522;437
ISIC_0012547;450;4;1;0.1;0.6;4288;2848;12212224;11128466;116135;11128466;572681;456546;11244601;527
ISIC_0007332;50;3;2;0.1;0.6;3024;2016;6096384;5240975;0;5240975;530766;530766;5240975;37
ISIC_0013188;50;2;2;0.1;0.6;3008;2000;6016000;5404025;0;5404025;92544;92544;5404025;22
ISIC_0008524;250;2;1;0.01;0.6;4288;2848;12212224;4768292;0;4768292;323767;323767;4768292;256
ISIC_0007332;400;4;3;10.0;0.6;3024;2016;6096384;4766796;0;4766796;530766;530766;4766796;479
ISIC_0003657;400;4;3;1.0;0.6;3024;2016;6096384;1481793;4145;1481793;340261;336116;1485938;478
ISIC_0013082;150;2;1;100.0;0.6;3872;2592;10036224;2759697;183;2759697;254836;254653;2759880;140
ISIC_0013188;150;4;3;0.1;0.6;3008;2000;6016000;4439780;0;4439780;92544;92544;4439780;177
ISIC_0014623;200;4;3;10.0;0.6;2592;1936;5018112;1160552;976721;1160552;1937167;960446;2137273;239
ISIC_0014428;300;3;1;10.0;0.6;4288;2848;12212224;1211474;1843;1211474;525860;524017;1213317;334
ISIC_0013188;50;2;3;1.0;0.6;3008;2000;6016000;5071102;0;5071102;92544;92544;5071102;28
ISIC_0003657;250;1;2;0.01;0.6;3024;2016;6096384;2184076;11424;2184076;340261;328837;2195500;246
ISIC_0008524;300;3;1;0.1;0.6;4288;2848;12212224;4281854;9969;4281854;323767;313798;4291823;332
ISIC_0014428;300;1;3;1.0;0.6;4288;2848;12212224;1251458;2278;1251458;525860;523582;1253736;313
ISIC_0012547;150;4;2;10.0;0.6;4288;2848;12212224;11558318;0;11558318;572681;572681;11558318;174
ISIC_0007332;150;2;2;1.0;0.6;3024;2016;6096384;5525218;0;5525218;530766;530766;5525218;143
ISIC_0003657;200;4;2;0.01;0.6;3024;2016;6096384;1796255;17405;1796255;340261;322856;1813660;231
ISIC_0012547;350;1;2;100.0;0.6;4288;2848;12212224;11289045;36400;11289045;572681;536281;11325445;370
ISIC_0014623;150;4;1;100.0;0.6;2592;1936;5018112;1308177;887004;1308177;1937167;1050163;2195181;170
ISIC_0003657;250;4;1;0.01;0.6;3024;2016;6096384;1764411;25;1764411;340261;340236;1764436;286
ISIC_0013128;150;2;2;0.01;0.6;3872;2592;10036224;6049044;0;6049044;470897;470897;6049044;141
ISIC_0013128;150;4;2;0.01;0.6;3872;2592;10036224;5827182;0;5827182;470897;470897;5827182;171
ISIC_0008524;50;1;1;10.0;0.6;4288;2848;12212224;6157070;12081;6157070;323767;311686;6169151;4
ISIC_0014623;300;2;2;100.0;0.6;2592;1936;5018112;1113840;1061439;1113840;1937167;875728;2175279;325
ISIC_0013128;150;3;3;1.0;0.6;3872;2592;10036224;5745612;0;5745612;470897;470897;5745612;163
ISIC_0013082;150;4;2;100.0;0.6;3872;2592;10036224;2759697;183;2759697;254836;254653;2759880;175
ISIC_0013082;50;3;3;0.01;0.6;3872;2592;10036224;3435159;7454;3435159;254836;247382;3442613;41
ISIC_0014712;450;2;3;0.1;0.6;6621;4422;29278062;1014410;18535474;1014410;24292916;5757442;19549884;507
ISIC_0014712;450;3;1;100.0;0.6;6621;4422;29278062;1061987;18360557;1061987;24292916;5932359;19422544;515
ISIC_0013128;50;1;1;0.1;0.6;3872;2592;10036224;7283961;0;7283961;470897;470897;7283961;2
ISIC_0003657;300;3;3;10.0;0.6;3024;2016;6096384;1602826;2337;1602826;340261;337924;1605163;344
ISIC_0003657;450;4;3;1.0;0.6;3024;2016;6096384;1372828;1871;1372828;340261;338390;1374699;538
ISIC_0012547;300;2;3;1.0;0.6;4288;2848;12212224;11388008;40564;11388008;572681;532117;11428572;328
ISIC_0014428;50;3;3;1.0;0.6;4288;2848;12212224;3157129;1576;3157129;525860;524284;3158705;43
ISIC_0013128;300;4;1;1.0;0.6;3872;2592;10036224;4966229;55;4966229;470897;470842;4966284;348
ISIC_0003657;250;1;1;10.0;0.6;3024;2016;6096384;2034245;296;2034245;340261;339965;2034541;244
ISIC_0014712;300;2;1;1.0;0.6;6621;4422;29278062;1318800;17086640;1318800;24292916;7206276;18405440;318
ISIC_0013188;400;2;3;0.1;0.6;3008;2000;6016000;3134290;0;3134290;92544;92544;3134290;447
ISIC_0013082;350;1;3;100.0;0.6;3872;2592;10036224;1955510;0;1955510;254836;254836;1955510;375
ISIC_0003657;150;1;2;10.0;0.6;3024;2016;6096384;2377437;1986;2377437;340261;338275;2379423;129
ISIC_0012547;200;1;2;10.0;0.6;4288;2848;12212224;11253395;0;11253395;572681;572681;11253395;189
ISIC_0013082;250;3;2;0.1;0.6;3872;2592;10036224;1886623;9502;1886623;254836;245334;1896125;277
ISIC_0014428;150;2;1;10.0;0.6;4288;2848;12212224;2072040;990;2072040;525860;524870;2073030;139
ISIC_0008524;350;1;1;10.0;0.6;4288;2848;12212224;4242253;277;4242253;323767;323490;4242530;364
ISIC_0014428;450;1;1;0.1;0.6;4288;2848;12212224;1123552;0;1123552;525860;525860;1123552;482
ISIC_0013188;300;2;2;0.1;0.6;3008;2000;6016000;3668962;0;3668962;92544;92544;3668962;322
ISIC_0012547;250;1;2;0.01;0.6;4288;2848;12212224;11474320;0;11474320;572681;572681;11474320;246
ISIC_0013128;50;2;2;0.01;0.6;3872;2592;10036224;7892703;0;7892703;470897;470897;7892703;21
ISIC_0007332;150;1;1;0.1;0.6;3024;2016;6096384;5522238;0;5522238;530766;530766;5522238;122
ISIC_0007332;50;3;1;1.0;0.6;3024;2016;6096384;5116916;0;5116916;530766;530766;5116916;33
ISIC_0013128;350;1;3;1.0;0.6;3872;2592;10036224;4994271;0;4994271;470897;470897;4994271;373
ISIC_0013188;50;2;1;10.0;0.6;3008;2000;6016000;5061942;0;5061942;92544;92544;5061942;19
ISIC_0014428;150;3;1;0.01;0.6;4288;2848;12212224;1852265;0;1852265;525860;525860;1852265;151
ISIC_0013188;100;2;2;10.0;0.6;3008;2000;6016000;4801202;0;4801202;92544;92544;4801202;84
ISIC_0013128;450;4;2;100.0;0.6;3872;2592;10036224;4438035;0;4438035;470897;470897;4438035;535
ISIC_0014712;400;4;3;0.1;0.6;6621;4422;29278062;1199039;19164021;1199039;24292916;5128895;20363060;477
ISIC_0014623;100;1;1;0.01;0.6;2592;1936;5018112;1879451;591676;1879451;1937167;1345491;2471127;61
ISIC_0008524;250;1;1;1.0;0.6;4288;2848;12212224;4539233;8107;4539233;323767;315660;4547340;243
ISIC_0014712;450;2;2;100.0;0.6;6621;4422;29278062;1061981;18096632;1061981;24292916;6196284;19158613;505
ISIC_0013188;300;4;1;0.01;0.6;3008;2000;6016000;3817517;0;3817517;92544;92544;3817517;346
ISIC_0014712;400;1;1;0.01;0.6;6621;4422;29278062;1288873;16358935;1288873;24292916;7933981;17647808;421
ISIC_0008524;100;1;3;10.0;0.6;4288;2848;12212224;5653290;4776;5653290;323767;318991;5658066;74
ISIC_0003657;400;1;1;0.1;0.6;3024;2016;6096384;1804950;0;1804950;340261;340261;1804950;422
ISIC_0008524;350;4;2;0.01;0.6;4288;2848;12212224;3417639;1204;3417639;323767;322563;3418843;411
ISIC_0013188;250;1;2;0.01;0.6;3008;2000;6016000;4009879;0;4009879;92544;92544;4009879;246
ISIC_0014623;150;3;2;100.0;0.6;2592;1936;5018112;1369170;887071;1369170;1937167;1050096;2256241;160
ISIC_0014623;400;4;3;0.1;0.6;2592;1936;5018112;977610;1145625;977610;1937167;791542;2123235;477
ISIC_0007332;300;3;1;1.0;0.6;3024;2016;6096384;5088406;0;5088406;530766;530766;5088406;333
ISIC_0007332;450;2;2;10.0;0.6;3024;2016;6096384;4683750;83;4683750;530766;530683;4683833;504
ISIC_0013082;350;2;1;100.0;0.6;3872;2592;10036224;1955511;0;1955511;254836;254836;1955511;380
ISIC_0013082;100;4;2;0.1;0.6;3872;2592;10036224;3293506;0;3293506;254836;254836;3293506;112
ISIC_0003657;100;2;3;0.1;0.6;3024;2016;6096384;2595479;60;2595479;340261;340201;2595539;87
ISIC_0012547;150;1;3;0.01;0.6;4288;2848;12212224;0;572681;0;572681;0;572681;131
ISIC_0012547;200;1;2;0.1;0.6;4288;2848;12212224;11509785;0;11509785;572681;572681;11509785;187
ISIC_0007332;350;2;2;0.01;0.6;3024;2016;6096384;4819325;0;4819325;530766;530766;4819325;381
ISIC_0014623;400;1;2;0.01;0.6;2592;1936;5018112;1117367;978515;1117367;1937167;958652;2095882;426
ISIC_0013082;400;3;2;0.01;0.6;3872;2592;10036224;1469719;57;1469719;254836;254779;1469776;456
ISIC_0013128;100;3;1;100.0;0.6;3872;2592;10036224;6560552;0;6560552;470897;470897;6560552;95
ISIC_0014712;300;1;2;0.01;0.6;6621;4422;29278062;1348215;16446616;1348215;24292916;7846300;17794831;306
ISIC_0013128;400;2;3;10.0;0.6;3872;2592;10036224;4607542;0;4607542;470897;470897;4607542;449
ISIC_0012547;450;2;1;0.01;0.6;4288;2848;12212224;11277544;41430;11277544;572681;531251;11318974;496
ISIC_0008524;400;3;3;10.0;0.6;4288;2848;12212224;3931653;13085;3931653;323767;310682;3944738;464
ISIC_0014428;300;3;3;10.0;0.6;4288;2848;12212224;1211478;1843;1211478;525860;524017;1213321;344
ISIC_0014623;200;1;1;0.1;0.6;2592;1936;5018112;1356962;791079;1356962;1937167;1146088;2148041;182
ISIC_0014428;400;1;1;0.1;0.6;4288;2848;12212224;1145189;1025;1145189;525860;524835;1146214;422
ISIC_0007332;300;4;3;100.0;0.6;3024;2016;6096384;5088423;0;5088423;530766;530766;5088423;360
ISIC_0013188;250;3;2;1.0;0.6;3008;2000;6016000;3822113;0;3822113;92544;92544;3822113;278
ISIC_0013082;200;1;2;0.1;0.6;3872;2592;10036224;2039576;1316;2039576;254836;253520;2040892;187
ISIC_0013188;400;1;2;0.1;0.6;3008;2000;6016000;3185428;0;3185428;92544;92544;3185428;427
ISIC_0012547;350;1;2;0.1;0.6;4288;2848;12212224;11263157;0;11263157;572681;572681;11263157;367
ISIC_0007332;400;3;1;0.1;0.6;3024;2016;6096384;4692448;0;4692448;530766;530766;4692448;452
ISIC_0014623;400;1;3;10.0;0.6;2592;1936;5018112;1185963;966885;1185963;1937167;970282;2152848;434
ISIC_0014712;450;2;2;0.01;0.6;6621;4422;29278062;931153;18033135;931153;24292916;6259781;18964288;501
ISIC_0014428;150;2;1;1.0;0.6;4288;2848;12212224;1985737;3192;1985737;525860;522668;1988929;138
ISIC_0013188;50;2;3;0.01;0.6;3008;2000;6016000;5521657;0;5521657;92544;92544;5521657;26
ISIC_0012547;300;1;1;0.01;0.6;4288;2848;12212224;11511175;0;11511175;572681;572681;11511175;301
ISIC_0013188;400;3;3;100.0;0.6;3008;2000;6016000;3250018;0;3250018;92544;92544;3250018;465
ISIC_0013188;250;2;2;10.0;0.6;3008;2000;6016000;3820182;0;3820182;92544;92544;3820182;264
ISIC_0013188;300;2;3;0.01;0.6;3008;2000;6016000;3711905;0;3711905;92544;92544;3711905;326
ISIC_0008524;450;1;1;1.0;0.6;4288;2848;12212224;4009132;22726;4009132;323767;301041;4031858;483
ISIC_0014623;100;3;3;0.01;0.6;2592;1936;5018112;1741800;727587;1741800;1937167;1209580;2469387;101
ISIC_0013082;250;3;1;1.0;0.6;3872;2592;10036224;2066684;0;2066684;254836;254836;2066684;273
ISIC_0014712;350;4;2;0.01;0.6;6621;4422;29278062;1040104;18514553;1040104;24292916;5778363;19554657;411
ISIC_0008524;150;1;3;10.0;0.6;4288;2848;12212224;4994089;5649;4994089;323767;318118;4999738;134
ISIC_0013188;150;3;2;0.1;0.6;3008;2000;6016000;4480622;0;4480622;92544;92544;4480622;157
ISIC_0012547;400;4;2;10.0;0.6;4288;2848;12212224;11164541;122500;11164541;572681;450181;11287041;474
ISIC_0014712;150;3;3;10.0;0.6;6621;4422;29278062;1997847;15360548;1997847;24292916;8932368;17358395;164
ISIC_0012547;400;1;2;100.0;0.6;4288;2848;12212224;11250166;0;11250166;572681;572681;11250166;430
ISIC_0007332;200;2;3;0.01;0.6;3024;2016;6096384;5177864;0;5177864;530766;530766;5177864;206
ISIC_0007332;350;3;2;10.0;0.6;3024;2016;6096384;4872093;0;4872093;530766;530766;4872093;399
ISIC_0014712;450;3;2;100.0;0.6;6621;4422;29278062;1061981;18360557;1061981;24292916;5932359;19422538;520
ISIC_0008524;100;4;1;1.0;0.6;4288;2848;12212224;4983404;3263;4983404;323767;320504;4986667;108
ISIC_0013188;250;3;1;0.01;0.6;3008;2000;6016000;3981476;0;3981476;92544;92544;3981476;271
ISIC_0014623;50;2;2;0.01;0.6;2592;1936;5018112;2237597;393060;2237597;1937167;1544107;2630657;21
ISIC_0014623;350;4;1;1.0;0.6;2592;1936;5018112;960384;1143792;960384;1937167;793375;2104176;408
ISIC_0014428;100;1;2;10.0;0.6;4288;2848;12212224;2634492;536;2634492;525860;525324;2635028;69
ISIC_0013082;300;3;1;0.1;0.6;3872;2592;10036224;1977619;3971;1977619;254836;250865;1981590;332
ISIC_0013128;350;1;2;0.1;0.6;3872;2592;10036224;5066220;0;5066220;470897;470897;5066220;367
ISIC_0014712;50;1;2;10.0;0.6;6621;4422;29278062;2825609;10386461;2825609;24292916;13906455;13212070;9
ISIC_0014712;400;4;3;10.0;0.6;6621;4422;29278062;1232283;18911066;1232283;24292916;5381850;20143349;479
ISIC_0008524;200;2;1;0.01;0.6;4288;2848;12212224;4899122;0;4899122;323767;323767;4899122;196
ISIC_0013188;150;2;1;10.0;0.6;3008;2000;6016000;4477346;0;4477346;92544;92544;4477346;139
ISIC_0012547;100;2;1;10.0;0.6;4288;2848;12212224;0;572681;0;572681;0;572681;79
ISIC_0013128;50;2;2;1.0;0.6;3872;2592;10036224;6961307;0;6961307;470897;470897;6961307;23
ISIC_0013082;350;4;3;10.0;0.6;3872;2592;10036224;1955525;0;1955525;254836;254836;1955525;419
ISIC_0014428;50;4;2;100.0;0.6;4288;2848;12212224;2715313;1211;2715313;525860;524649;2716524;55
ISIC_0012547;250;4;2;0.01;0.6;4288;2848;12212224;11563956;0;11563956;572681;572681;11563956;291
ISIC_0003657;50;1;1;10.0;0.6;3024;2016;6096384;2886232;72;2886232;340261;340189;2886304;4
ISIC_0013082;300;4;3;1.0;0.6;3872;2592;10036224;2130610;1545;2130610;254836;253291;2132155;358
ISIC_0007332;50;1;1;100.0;0.6;3024;2016;6096384;5142926;0;5142926;530766;530766;5142926;5
ISIC_0014428;400;1;1;0.01;0.6;4288;2848;12212224;1305809;5692;1305809;525860;520168;1311501;421
ISIC_0014428;350;3;2;0.01;0.6;4288;2848;12212224;959456;146;959456;525860;525714;959602;396
ISIC_0014623;450;2;3;0.01;0.6;2592;1936;5018112;992399;1105229;992399;1937167;831938;2097628;506
ISIC_0014623;150;1;3;10.0;0.6;2592;1936;5018112;1658865;679444;1658865;1937167;1257723;2338309;134
ISIC_0014623;400;3;1;100.0;0.6;2592;1936;5018112;1009209;1100070;1009209;1937167;837097;2109279;455
ISIC_0013082;50;1;2;10.0;0.6;3872;2592;10036224;3808938;0;3808938;254836;254836;3808938;9
ISIC_0014712;300;4;1;0.01;0.6;6621;4422;29278062;1333854;17894492;1333854;24292916;6398424;19228346;346
ISIC_0014623;450;1;1;0.01;0.6;2592;1936;5018112;1125482;1016285;1125482;1937167;920882;2141767;481
ISIC_0013082;200;1;3;100.0;0.6;3872;2592;10036224;2123938;200;2123938;254836;254636;2124138;195
ISIC_0003657;100;1;2;10.0;0.6;3024;2016;6096384;2754355;30;2754355;340261;340231;2754385;69
ISIC_0013128;450;1;2;10.0;0.6;3872;2592;10036224;4786516;0;4786516;470897;470897;4786516;489
ISIC_0008524;50;3;2;0.1;0.6;4288;2848;12212224;7153540;0;7153540;323767;323767;7153540;37
ISIC_0013188;350;2;2;0.01;0.6;3008;2000;6016000;3574611;0;3574611;92544;92544;3574611;381
ISIC_0014712;250;4;3;1.0;0.6;6621;4422;29278062;1784874;17881667;1784874;24292916;6411249;19666541;298
ISIC_0014623;350;2;3;0.01;0.6;2592;1936;5018112;1073438;1047113;1073438;1937167;890054;2120551;386
ISIC_0013128;400;1;1;0.01;0.6;3872;2592;10036224;4927168;0;4927168;470897;470897;4927168;421
ISIC_0007332;250;2;2;1.0;0.6;3024;2016;6096384;5174639;895;5174639;530766;529871;5175534;263
ISIC_0014712;350;1;2;10.0;0.6;6621;4422;29278062;1259761;15588503;1259761;24292916;8704413;16848264;369
ISIC_0013082;50;3;2;0.01;0.6;3872;2592;10036224;3660570;0;3660570;254836;254836;3660570;36
ISIC_0014623;450;1;1;100.0;0.6;2592;1936;5018112;1111362;1023020;1111362;1937167;914147;2134382;485
ISIC_0014428;250;1;3;0.01;0.6;4288;2848;12212224;1226756;17484;1226756;525860;508376;1244240;251
ISIC_0012547;50;1;3;1.0;0.6;4288;2848;12212224;10803279;0;10803279;572681;572681;10803279;13
ISIC_0014428;400;3;3;1.0;0.6;4288;2848;12212224;1014410;4506;1014410;525860;521354;1018916;463
ISIC_0014623;400;4;1;10.0;0.6;2592;1936;5018112;976462;1143080;976462;1937167;794087;2119542;469
ISIC_0012547;200;1;3;0.1;0.6;4288;2848;12212224;11509653;0;11509653;572681;572681;11509653;192
ISIC_0014428;300;2;1;10.0;0.6;4288;2848;12212224;1252278;1843;1252278;525860;524017;1254121;319
ISIC_0012547;200;1;1;100.0;0.6;4288;2848;12212224;11252566;0;11252566;572681;572681;11252566;185
ISIC_0013082;50;1;1;0.1;0.6;3872;2592;10036224;3872991;2865;3872991;254836;251971;3875856;2
ISIC_0003657;200;2;2;1.0;0.6;3024;2016;6096384;1908265;372;1908265;340261;339889;1908637;203
ISIC_0003657;200;1;3;0.1;0.6;3024;2016;6096384;2278931;0;2278931;340261;340261;2278931;192
ISIC_0008524;150;1;2;0.1;0.6;4288;2848;12212224;5352339;0;5352339;323767;323767;5352339;127
ISIC_0012547;300;4;3;1.0;0.6;4288;2848;12212224;11302920;163216;11302920;572681;409465;11466136;358
ISIC_0014428;350;2;2;100.0;0.6;4288;2848;12212224;1232873;6259;1232873;525860;519601;1239132;385
ISIC_0014428;200;2;1;0.01;0.6;4288;2848;12212224;1668916;0;1668916;525860;525860;1668916;196
ISIC_0008524;50;4;2;0.1;0.6;4288;2848;12212224;6014605;3418;6014605;323767;320349;6018023;52
ISIC_0007332;400;2;1;10.0;0.6;3024;2016;6096384;4811876;0;4811876;530766;530766;4811876;439
ISIC_0014623;200;3;1;10.0;0.6;2592;1936;5018112;1235445;918841;1235445;1937167;1018326;2154286;214
ISIC_0003657;350;1;2;10.0;0.6;3024;2016;6096384;1804578;2927;1804578;340261;337334;1807505;369
ISIC_0013082;200;4;2;1.0;0.6;3872;2592;10036224;2131293;568;2131293;254836;254268;2131861;233
ISIC_0013128;200;4;3;0.01;0.6;3872;2592;10036224;5445741;0;5445741;470897;470897;5445741;236
ISIC_0014428;200;4;1;10.0;0.6;4288;2848;12212224;1439183;999;1439183;525860;524861;1440182;229
ISIC_0014428;350;3;1;10.0;0.6;4288;2848;12212224;1232873;6259;1232873;525860;519601;1239132;394
ISIC_0013128;200;2;3;0.1;0.6;3872;2592;10036224;5660347;0;5660347;470897;470897;5660347;207
ISIC_0014428;400;3;3;0.01;0.6;4288;2848;12212224;876297;15531;876297;525860;510329;891828;461
ISIC_0013188;150;4;3;0.01;0.6;3008;2000;6016000;4470775;0;4470775;92544;92544;4470775;176
ISIC_0013128;100;1;3;1.0;0.6;3872;2592;10036224;6977078;0;6977078;470897;470897;6977078;73
ISIC_0014712;100;2;3;10.0;0.6;6621;4422;29278062;3327019;12127742;3327019;24292916;12165174;15454761;89
ISIC_0014623;300;3;2;0.01;0.6;2592;1936;5018112;1062601;1036699;1062601;1937167;900468;2099300;336
ISIC_0014623;350;3;2;1.0;0.6;2592;1936;5018112;1040473;1054310;1040473;1937167;882857;2094783;398
ISIC_0013082;150;4;1;0.1;0.6;3872;2592;10036224;2451192;6077;2451192;254836;248759;2457269;167
ISIC_0003657;300;4;2;10.0;0.6;3024;2016;6096384;1540324;2883;1540324;340261;337378;1543207;354
ISIC_0013128;450;3;3;1.0;0.6;3872;2592;10036224;4621087;0;4621087;470897;470897;4621087;523
ISIC_0013128;150;2;1;100.0;0.6;3872;2592;10036224;5812685;0;5812685;470897;470897;5812685;140
ISIC_0012547;100;3;1;0.1;0.6;4288;2848;12212224;0;572681;0;572681;0;572681;92
ISIC_0013188;350;3;1;100.0;0.6;3008;2000;6016000;3509667;0;3509667;92544;92544;3509667;395
ISIC_0003657;300;3;1;10.0;0.6;3024;2016;6096384;1603022;2337;1603022;340261;337924;1605359;334
ISIC_0008524;350;2;2;1.0;0.6;4288;2848;12212224;4001149;4484;4001149;323767;319283;4005633;383
ISIC_0013188;100;1;3;1.0;0.6;3008;2000;6016000;4863193;0;4863193;92544;92544;4863193;73
ISIC_0013188;300;4;3;1.0;0.6;3008;2000;6016000;3675914;40;3675914;92544;92504;3675954;358
ISIC_0014428;400;4;3;10.0;0.6;4288;2848;12212224;1078368;2796;1078368;525860;523064;1081164;479
ISIC_0007332;400;4;1;100.0;0.6;3024;2016;6096384;4766918;0;4766918;530766;530766;4766918;470
ISIC_0013082;400;3;1;100.0;0.6;3872;2592;10036224;1834504;0;1834504;254836;254836;1834504;455
ISIC_0007332;350;1;2;0.01;0.6;3024;2016;6096384;4811988;0;4811988;530766;530766;4811988;366
ISIC_0007332;300;4;3;1.0;0.6;3024;2016;6096384;5067863;0;5067863;530766;530766;5067863;358
ISIC_0014623;400;3;3;0.1;0.6;2592;1936;5018112;1012740;1105438;1012740;1937167;831729;2118178;462
ISIC_0013128;50;2;1;100.0;0.6;3872;2592;10036224;6970975;0;6970975;470897;470897;6970975;20
ISIC_0013128;250;1;2;100.0;0.6;3872;2592;10036224;5441512;0;5441512;470897;470897;5441512;250
ISIC_0013188;250;1;3;1.0;0.6;3008;2000;6016000;3846032;0;3846032;92544;92544;3846032;253
ISIC_0008524;300;2;3;1.0;0.6;4288;2848;12212224;4438027;1333;4438027;323767;322434;4439360;328
ISIC_0003657;100;4;3;100.0;0.6;3024;2016;6096384;2310003;30;2310003;340261;340231;2310033;120
ISIC_0003657;450;3;3;0.01;0.6;3024;2016;6096384;1447861;12990;1447861;340261;327271;1460851;521
ISIC_0014712;150;3;3;1.0;0.6;6621;4422;29278062;1999260;15360638;1999260;24292916;8932278;17359898;163
ISIC_0013188;200;3;3;1.0;0.6;3008;2000;6016000;4062498;0;4062498;92544;92544;4062498;223
ISIC_0008524;50;4;2;1.0;0.6;4288;2848;12212224;5478411;13651;5478411;323767;310116;5492062;53
ISIC_0014428;50;4;1;0.1;0.6;4288;2848;12212224;2814570;8441;2814570;525860;517419;2823011;47
ISIC_0013128;400;3;2;0.1;0.6;3872;2592;10036224;4656992;0;4656992;470897;470897;4656992;457
ISIC_0007332;100;1;2;100.0;0.6;3024;2016;6096384;0;530766;0;530766;0;530766;70
ISIC_0014428;250;3;2;1.0;0.6;4288;2848;12212224;1411336;0;1411336;525860;525860;1411336;278
ISIC_0014428;450;3;3;10.0;0.6;4288;2848;12212224;1128313;8163;1128313;525860;517697;1136476;524
ISIC_0014623;450;3;2;10.0;0.6;2592;1936;5018112;954530;1178444;954530;1937167;758723;2132974;519
ISIC_0013082;150;4;3;10.0;0.6;3872;2592;10036224;2759696;183;2759696;254836;254653;2759879;179
ISIC_0014428;150;4;3;100.0;0.6;4288;2848;12212224;1828088;990;1828088;525860;524870;1829078;180
ISIC_0003657;250;2;2;0.01;0.6;3024;2016;6096384;2071985;4917;2071985;340261;335344;2076902;261
ISIC_0014712;250;3;3;0.01;0.6;6621;4422;29278062;1437362;17324847;1437362;24292916;6968069;18762209;281
ISIC_0007332;50;2;3;1.0;0.6;3024;2016;6096384;5117158;0;5117158;530766;530766;5117158;28
ISIC_0014712;150;1;2;0.01;0.6;6621;4422;29278062;1894958;12944630;1894958;24292916;11348286;14839588;126
ISIC_0014428;50;1;1;1.0;0.6;4288;2848;12212224;3159334;1637;3159334;525860;524223;3160971;3
ISIC_0013128;50;3;1;100.0;0.6;3872;2592;10036224;6970985;0;6970985;470897;470897;6970985;35
ISIC_0003657;450;1;3;0.01;0.6;3024;2016;6096384;1729854;14322;1729854;340261;325939;1744176;491
ISIC_0014428;50;1;2;10.0;0.6;4288;2848;12212224;2715594;1211;2715594;525860;524649;2716805;9
ISIC_0014623;50;2;1;0.1;0.6;2592;1936;5018112;2044502;454412;2044502;1937167;1482755;2498914;17
ISIC_0014623;250;1;3;0.1;0.6;2592;1936;5018112;1385581;922418;1385581;1937167;1014749;2307999;252
ISIC_0014428;400;2;1;100.0;0.6;4288;2848;12212224;1140493;2798;1140493;525860;523062;1143291;440
ISIC_0008524;100;2;1;0.1;0.6;4288;2848;12212224;5688835;4797;5688835;323767;318970;5693632;77
ISIC_0003657;150;3;3;0.1;0.6;3024;2016;6096384;2137989;1261;2137989;340261;339000;2139250;162
ISIC_0013082;100;2;3;100.0;0.6;3872;2592;10036224;2998256;0;2998256;254836;254836;2998256;90
ISIC_0012547;50;4;3;10.0;0.6;4288;2848;12212224;10807556;0;10807556;572681;572681;10807556;59
ISIC_0007332;100;3;3;1.0;0.6;3024;2016;6096384;0;530766;0;530766;0;530766;103
ISIC_0007332;450;1;3;10.0;0.6;3024;2016;6096384;4697322;83;4697322;530766;530683;4697405;494
ISIC_0013188;400;1;1;10.0;0.6;3008;2000;6016000;3265147;0;3265147;92544;92544;3265147;424
ISIC_0008524;100;3;1;0.1;0.6;4288;2848;12212224;5693083;4769;5693083;323767;318998;5697852;92
ISIC_0008524;100;2;1;100.0;0.6;4288;2848;12212224;5531629;4774;5531629;323767;318993;5536403;80
ISIC_0012547;150;2;1;1.0;0.6;4288;2848;12212224;11557893;0;11557893;572681;572681;11557893;138
ISIC_0012547;250;1;1;100.0;0.6;4288;2848;12212224;11494346;0;11494346;572681;572681;11494346;245
ISIC_0008524;250;3;3;0.1;0.6;4288;2848;12212224;4426573;6136;4426573;323767;317631;4432709;282
ISIC_0013188;300;2;2;1.0;0.6;3008;2000;6016000;3695931;35;3695931;92544;92509;3695966;323
ISIC_0014428;150;4;2;10.0;0.6;4288;2848;12212224;1828088;990;1828088;525860;524870;1829078;174
ISIC_0013082;200;3;3;0.01;0.6;3872;2592;10036224;2187950;17517;2187950;254836;237319;2205467;221
ISIC_0014623;200;3;3;0.1;0.6;2592;1936;5018112;1215185;868336;1215185;1937167;1068831;2083521;222
ISIC_0014428;200;1;2;0.1;0.6;4288;2848;12212224;1685660;0;1685660;525860;525860;1685660;187
ISIC_0014712;200;3;1;1.0;0.6;6621;4422;29278062;1513910;16606328;1513910;24292916;7686588;18120238;213
ISIC_0013082;100;3;3;0.01;0.6;3872;2592;10036224;2740134;10338;2740134;254836;244498;2750472;101
ISIC_0012547;100;1;3;100.0;0.6;4288;2848;12212224;0;572681;0;572681;0;572681;75
ISIC_0013082;100;2;2;1.0;0.6;3872;2592;10036224;2998050;0;2998050;254836;254836;2998050;83
ISIC_0013128;250;2;2;10.0;0.6;3872;2592;10036224;5441794;0;5441794;470897;470897;5441794;264
ISIC_0014623;450;4;3;10.0;0.6;2592;1936;5018112;875464;1217729;875464;1937167;719438;2093193;539
ISIC_0013188;450;2;3;10.0;0.6;3008;2000;6016000;3126155;0;3126155;92544;92544;3126155;509
ISIC_0013128;200;3;2;1.0;0.6;3872;2592;10036224;5614887;0;5614887;470897;470897;5614887;218
ISIC_0014623;250;3;1;0.1;0.6;2592;1936;5018112;1206378;1005821;1206378;1937167;931346;2212199;272
ISIC_0007332;400;2;1;0.01;0.6;3024;2016;6096384;4814160;0;4814160;530766;530766;4814160;436
ISIC_0013188;450;4;2;1.0;0.6;3008;2000;6016000;3152454;339;3152454;92544;92205;3152793;533
ISIC_0003657;100;3;1;1.0;0.6;3024;2016;6096384;2440931;361;2440931;340261;339900;2441292;93
ISIC_0013188;50;2;2;0.01;0.6;3008;2000;6016000;5520528;0;5520528;92544;92544;5520528;21
ISIC_0008524;200;2;2;1.0;0.6;4288;2848;12212224;4756148;9702;4756148;323767;314065;4765850;203
ISIC_0013082;400;3;1;10.0;0.6;3872;2592;10036224;1834346;0;1834346;254836;254836;1834346;454
ISIC_0008524;350;4;2;10.0;0.6;4288;2848;12212224;3333251;277;3333251;323767;323490;3333528;414
ISIC_0014623;350;1;3;10.0;0.6;2592;1936;5018112;1183107;941062;1183107;1937167;996105;2124169;374
ISIC_0014712;50;1;1;0.1;0.6;6621;4422;29278062;2818522;10441687;2818522;24292916;13851229;13260209;2
ISIC_0013128;200;4;2;100.0;0.6;3872;2592;10036224;5464777;0;5464777;470897;470897;5464777;235
ISIC_0003657;350;4;2;100.0;0.6;3024;2016;6096384;1523883;2927;1523883;340261;337334;1526810;415
ISIC_0013188;250;1;3;0.01;0.6;3008;2000;6016000;3934131;1570;3934131;92544;90974;3935701;251
ISIC_0014623;200;3;1;1.0;0.6;2592;1936;5018112;1235817;944338;1235817;1937167;992829;2180155;213
ISIC_0014623;50;4;2;100.0;0.6;2592;1936;5018112;2054480;436762;2054480;1937167;1500405;2491242;55
ISIC_0013128;250;1;1;10.0;0.6;3872;2592;10036224;5441312;0;5441312;470897;470897;5441312;244
ISIC_0003657;350;2;2;1.0;0.6;3024;2016;6096384;1646907;2927;1646907;340261;337334;1649834;383
ISIC_0008524;400;3;3;1.0;0.6;4288;2848;12212224;3945512;3702;3945512;323767;320065;3949214;463
ISIC_0007332;300;2;3;10.0;0.6;3024;2016;6096384;5108871;0;5108871;530766;530766;5108871;329
ISIC_0008524;250;3;3;0.01;0.6;4288;2848;12212224;4543528;11788;4543528;323767;311979;4555316;281
ISIC_0014623;150;3;2;1.0;0.6;2592;1936;5018112;1340866;886735;1340866;1937167;1050432;2227601;158
ISIC_0013128;100;1;2;100.0;0.6;3872;2592;10036224;6977543;0;6977543;470897;470897;6977543;70
ISIC_0007332;300;3;2;1.0;0.6;3024;2016;6096384;5088272;0;5088272;530766;530766;5088272;338
ISIC_0014623;200;3;2;0.01;0.6;2592;1936;5018112;1218070;930965;1218070;1937167;1006202;2149035;216
ISIC_0008524;300;2;1;10.0;0.6;4288;2848;12212224;4395364;4070;4395364;323767;319697;4399434;319
ISIC_0014428;200;4;2;10.0;0.6;4288;2848;12212224;1439184;999;1439184;525860;524861;1440183;234
ISIC_0007332;150;3;1;100.0;0.6;3024;2016;6096384;5525218;0;5525218;530766;530766;5525218;155
ISIC_0013128;50;2;1;0.1;0.6;3872;2592;10036224;7285017;0;7285017;470897;470897;7285017;17
ISIC_0013188;450;3;1;0.01;0.6;3008;2000;6016000;3260359;0;3260359;92544;92544;3260359;511
ISIC_0013082;100;2;2;10.0;0.6;3872;2592;10036224;2998472;0;2998472;254836;254836;2998472;84
ISIC_0013128;200;3;3;0.01;0.6;3872;2592;10036224;5838646;0;5838646;470897;470897;5838646;221
ISIC_0014428;250;1;2;100.0;0.6;4288;2848;12212224;1469675;4628;1469675;525860;521232;1474303;250
ISIC_0014712;50;4;1;100.0;0.6;6621;4422;29278062;2259591;13772368;2259591;24292916;10520548;16031959;50
ISIC_0014623;100;1;3;100.0;0.6;2592;1936;5018112;1634192;581054;1634192;1937167;1356113;2215246;75
ISIC_0014428;250;1;3;1.0;0.6;4288;2848;12212224;1514873;0;1514873;525860;525860;1514873;253
ISIC_0003657;250;2;1;0.01;0.6;3024;2016;6096384;2102623;6;2102623;340261;340255;2102629;256
ISIC_0003657;250;2;2;1.0;0.6;3024;2016;6096384;1824317;319;1824317;340261;339942;1824636;263
ISIC_0014712;400;4;3;1.0;0.6;6621;4422;29278062;1232270;18911046;1232270;24292916;5381870;20143316;478
ISIC_0012547;350;4;3;100.0;0.6;4288;2848;12212224;11254071;106338;11254071;572681;466343;11360409;420
ISIC_0013188;300;4;3;0.01;0.6;3008;2000;6016000;3632502;0;3632502;92544;92544;3632502;356
ISIC_0003657;250;3;1;0.01;0.6;3024;2016;6096384;1872135;35;1872135;340261;340226;1872170;271
ISIC_0014623;300;1;1;10.0;0.6;2592;1936;5018112;1226239;956160;1226239;1937167;981007;2182399;304
ISIC_0014623;450;3;1;10.0;0.6;2592;1936;5018112;954580;1178551;954580;1937167;758616;2133131;514
ISIC_0007332;150;3;1;1.0;0.6;3024;2016;6096384;5525218;0;5525218;530766;530766;5525218;153
ISIC_0007332;50;4;2;0.01;0.6;3024;2016;6096384;0;530766;0;530766;0;530766;51
ISIC_0013082;400;2;2;1.0;0.6;3872;2592;10036224;1813729;0;1813729;254836;254836;1813729;443
ISIC_0007332;200;3;3;0.1;0.6;3024;2016;6096384;5212067;0;5212067;530766;530766;5212067;222
ISIC_0014712;300;2;3;1.0;0.6;6621;4422;29278062;1318802;17086607;1318802;24292916;7206309;18405409;328
ISIC_0014623;350;1;1;0.01;0.6;2592;1936;5018112;1189938;936663;1189938;1937167;1000504;2126601;361
ISIC_0014428;200;3;1;1.0;0.6;4288;2848;12212224;1287007;2452;1287007;525860;523408;1289459;213
ISIC_0014428;50;4;3;0.1;0.6;4288;2848;12212224;2609910;8311;2609910;525860;517549;2618221;57
ISIC_0013128;300;3;2;100.0;0.6;3872;2592;10036224;5070752;39;5070752;470897;470858;5070791;340
ISIC_0014623;150;3;2;10.0;0.6;2592;1936;5018112;1369167;887071;1369167;1937167;1050096;2256238;159
ISIC_0012547;250;1;3;0.01;0.6;4288;2848;12212224;11476289;0;11476289;572681;572681;11476289;251
ISIC_0012547;250;1;2;0.1;0.6;4288;2848;12212224;11533471;0;11533471;572681;572681;11533471;247
ISIC_0013188;300;3;2;100.0;0.6;3008;2000;6016000;3696080;45;3696080;92544;92499;3696125;340
ISIC_0013128;350;4;3;0.01;0.6;3872;2592;10036224;4670625;0;4670625;470897;470897;4670625;416
ISIC_0003657;100;4;3;10.0;0.6;3024;2016;6096384;2310083;30;2310083;340261;340231;2310113;119
ISIC_0013188;100;3;2;100.0;0.6;3008;2000;6016000;4801213;0;4801213;92544;92544;4801213;100
ISIC_0014428;200;4;3;0.01;0.6;4288;2848;12212224;1206775;5729;1206775;525860;520131;1212504;236
ISIC_0012547;400;3;3;0.01;0.6;4288;2848;12212224;11400297;84878;11400297;572681;487803;11485175;461
ISIC_0012547;150;4;3;0.01;0.6;4288;2848;12212224;0;572681;0;572681;0;572681;176
ISIC_0007332;100;3;3;0.1;0.6;3024;2016;6096384;0;530766;0;530766;0;530766;102
ISIC_0014712;250;2;3;1.0;0.6;6621;4422;29278062;1784874;16828670;1784874;24292916;7464246;18613544;268
ISIC_0013082;400;1;3;0.01;0.6;3872;2592;10036224;1311532;14463;1311532;254836;240373;1325995;431
ISIC_0013128;100;1;1;100.0;0.6;3872;2592;10036224;6977526;0;6977526;470897;470897;6977526;65
ISIC_0003657;400;3;1;0.1;0.6;3024;2016;6096384;1562136;0;1562136;340261;340261;1562136;452
ISIC_0013188;100;1;1;0.1;0.6;3008;2000;6016000;4927130;0;4927130;92544;92544;4927130;62
ISIC_0013082;50;2;1;100.0;0.6;3872;2592;10036224;3808585;0;3808585;254836;254836;3808585;20
ISIC_0014623;450;4;3;0.01;0.6;2592;1936;5018112;856436;1260007;856436;1937167;677160;2116443;536
ISIC_0007332;450;2;1;10.0;0.6;3024;2016;6096384;4683670;83;4683670;530766;530683;4683753;499
ISIC_0014623;150;2;3;100.0;0.6;2592;1936;5018112;1568494;753653;1568494;1937167;1183514;2322147;150
ISIC_0007332;300;3;3;100.0;0.6;3024;2016;6096384;5108872;0;5108872;530766;530766;5108872;345
ISIC_0012547;300;2;2;0.01;0.6;4288;2848;12212224;11441383;0;11441383;572681;572681;11441383;321
ISIC_0008524;450;2;1;0.01;0.6;4288;2848;12212224;3896513;2533;3896513;323767;321234;3899046;496
ISIC_0003657;150;4;2;0.1;0.6;3024;2016;6096384;2111706;1331;2111706;340261;338930;2113037;172
ISIC_0014623;100;1;3;1.0;0.6;2592;1936;5018112;1676416;580989;1676416;1937167;1356178;2257405;73
ISIC_0014712;350;4;1;10.0;0.6;6621;4422;29278062;1244918;18095605;1244918;24292916;6197311;19340523;409
ISIC_0014712;300;3;2;100.0;0.6;6621;4422;29278062;1314378;17478141;1314378;24292916;6814775;18792519;340
ISIC_0012547;350;2;1;10.0;0.6;4288;2848;12212224;11254074;36400;11254074;572681;536281;11290474;379
ISIC_0012547;150;4;3;0.1;0.6;4288;2848;12212224;11469109;0;11469109;572681;572681;11469109;177
ISIC_0014623;150;1;1;10.0;0.6;2592;1936;5018112;1630444;679568;1630444;1937167;1257599;2310012;124
ISIC_0003657;50;4;2;100.0;0.6;3024;2016;6096384;2078464;72;2078464;340261;340189;2078536;55
ISIC_0014623;100;4;2;0.01;0.6;2592;1936;5018112;1722451;774741;1722451;1937167;1162426;2497192;111
ISIC_0007332;50;1;1;0.1;0.6;3024;2016;6096384;5356636;0;5356636;530766;530766;5356636;2
ISIC_0012547;300;4;1;10.0;0.6;4288;2848;12212224;11305031;163216;11305031;572681;409465;11468247;349
ISIC_0014428;200;2;3;0.1;0.6;4288;2848;12212224;1619910;0;1619910;525860;525860;1619910;207
ISIC_0008524;250;4;1;0.1;0.6;4288;2848;12212224;3729606;4651;3729606;323767;319116;3734257;287
ISIC_0013082;250;4;3;0.1;0.6;3872;2592;10036224;1958015;9440;1958015;254836;245396;1967455;297
ISIC_0008524;250;1;1;10.0;0.6;4288;2848;12212224;4539363;7441;4539363;323767;316326;4546804;244
ISIC_0007332;350;2;2;1.0;0.6;3024;2016;6096384;4872256;0;4872256;530766;530766;4872256;383
ISIC_0014712;250;1;1;10.0;0.6;6621;4422;29278062;2006293;15387164;2006293;24292916;8905752;17393457;244
ISIC_0014428;150;1;1;0.1;0.6;4288;2848;12212224;1910388;0;1910388;525860;525860;1910388;122
ISIC_0013128;300;3;1;0.1;0.6;3872;2592;10036224;5039874;0;5039874;470897;470897;5039874;332
ISIC_0012547;300;2;3;0.01;0.6;4288;2848;12212224;11444410;0;11444410;572681;572681;11444410;326
ISIC_0014428;200;3;2;1.0;0.6;4288;2848;12212224;1398722;2430;1398722;525860;523430;1401152;218
ISIC_0014623;400;3;2;10.0;0.6;2592;1936;5018112;1009203;1100183;1009203;1937167;836984;2109386;459
ISIC_0003657;450;2;2;0.1;0.6;3024;2016;6096384;1624821;0;1624821;340261;340261;1624821;502
ISIC_0013082;300;2;1;0.01;0.6;3872;2592;10036224;2225054;2398;2225054;254836;252438;2227452;316
ISIC_0013082;300;1;2;100.0;0.6;3872;2592;10036224;2201318;224;2201318;254836;254612;2201542;310
ISIC_0013188;100;4;3;10.0;0.6;3008;2000;6016000;4739050;0;4739050;92544;92544;4739050;119
ISIC_0014428;200;1;1;1.0;0.6;4288;2848;12212224;1355873;2891;1355873;525860;522969;1358764;183
ISIC_0014428;450;3;2;100.0;0.6;4288;2848;12212224;1128313;8163;1128313;525860;517697;1136476;520
ISIC_0008524;100;1;3;100.0;0.6;4288;2848;12212224;5653311;4774;5653311;323767;318993;5658085;75
ISIC_0003657;50;3;3;0.1;0.6;3024;2016;6096384;3068954;479;3068954;340261;339782;3069433;42
ISIC_0003657;100;1;3;0.01;0.6;3024;2016;6096384;2703598;17550;2703598;340261;322711;2721148;71
ISIC_0013128;50;4;2;10.0;0.6;3872;2592;10036224;6779340;0;6779340;470897;470897;6779340;54
ISIC_0008524;400;1;3;0.1;0.6;4288;2848;12212224;4110444;3520;4110444;323767;320247;4113964;432
ISIC_0014712;400;3;2;10.0;0.6;6621;4422;29278062;1239206;17659362;1239206;24292916;6633554;18898568;459
ISIC_0014712;300;1;1;0.01;0.6;6621;4422;29278062;1343117;16169559;1343117;24292916;8123357;17512676;301
ISIC_0013082;150;2;3;10.0;0.6;3872;2592;10036224;2759696;183;2759696;254836;254653;2759879;149
ISIC_0008524;300;2;3;0.01;0.6;4288;2848;12212224;4425400;308;4425400;323767;323459;4425708;326
ISIC_0014623;350;3;2;0.1;0.6;2592;1936;5018112;982335;1061007;982335;1937167;876160;2043342;397
ISIC_0014428;100;1;1;100.0;0.6;4288;2848;12212224;2634284;534;2634284;525860;525326;2634818;65
ISIC_0013128;200;2;2;100.0;0.6;3872;2592;10036224;5660983;0;5660983;470897;470897;5660983;205
ISIC_0014712;50;2;1;0.01;0.6;6621;4422;29278062;3299242;11201658;3299242;24292916;13091258;14500900;16
ISIC_0013188;150;3;1;10.0;0.6;3008;2000;6016000;4477346;0;4477346;92544;92544;4477346;154
ISIC_0013082;50;2;1;0.1;0.6;3872;2592;10036224;3454102;10970;3454102;254836;243866;3465072;17
ISIC_0013082;350;3;3;0.01;0.6;3872;2592;10036224;1477034;12625;1477034;254836;242211;1489659;401
ISIC_0013082;450;1;2;1.0;0.6;3872;2592;10036224;1742645;2980;1742645;254836;251856;1745625;488
ISIC_0013128;250;1;2;10.0;0.6;3872;2592;10036224;5441512;0;5441512;470897;470897;5441512;249
ISIC_0014428;450;2;1;1.0;0.6;4288;2848;12212224;1176323;1316;1176323;525860;524544;1177639;498
ISIC_0013128;350;1;1;10.0;0.6;3872;2592;10036224;5025818;0;5025818;470897;470897;5025818;364
ISIC_0014712;250;1;1;100.0;0.6;6621;4422;29278062;2006293;15387159;2006293;24292916;8905757;17393452;245
ISIC_0014428;50;2;1;1.0;0.6;4288;2848;12212224;3159792;1718;3159792;525860;524142;3161510;18
ISIC_0012547;300;4;2;1.0;0.6;4288;2848;12212224;11303195;163216;11303195;572681;409465;11466411;353
ISIC_0003657;250;3;3;10.0;0.6;3024;2016;6096384;1746014;296;1746014;340261;339965;1746310;284
ISIC_0013188;250;3;2;0.1;0.6;3008;2000;6016000;3752881;0;3752881;92544;92544;3752881;277
ISIC_0012547;200;1;1;0.01;0.6;4288;2848;12212224;11543302;0;11543302;572681;572681;11543302;181
ISIC_0013188;100;2;1;1.0;0.6;3008;2000;6016000;4800345;0;4800345;92544;92544;4800345;78
ISIC_0014712;400;4;1;100.0;0.6;6621;4422;29278062;1232291;18911561;1232291;24292916;5381355;20143852;470
ISIC_0012547;300;1;1;0.1;0.6;4288;2848;12212224;11365123;0;11365123;572681;572681;11365123;302
ISIC_0012547;150;3;3;100.0;0.6;4288;2848;12212224;11558318;0;11558318;572681;572681;11558318;165
ISIC_0007332;250;4;3;1.0;0.6;3024;2016;6096384;5150456;895;5150456;530766;529871;5151351;298
ISIC_0007332;350;4;1;10.0;0.6;3024;2016;6096384;4854535;0;4854535;530766;530766;4854535;409
ISIC_0012547;350;4;1;1.0;0.6;4288;2848;12212224;11254364;106338;11254364;572681;466343;11360702;408
ISIC_0014623;350;4;3;0.1;0.6;2592;1936;5018112;949136;1146585;949136;1937167;790582;2095721;417
ISIC_0014428;150;1;3;1.0;0.6;4288;2848;12212224;2149437;0;2149437;525860;525860;2149437;133
ISIC_0013128;200;1;1;10.0;0.6;3872;2592;10036224;5755525;0;5755525;470897;470897;5755525;184
ISIC_0003657;450;3;1;1.0;0.6;3024;2016;6096384;1412032;1871;1412032;340261;338390;1413903;513
ISIC_0008524;150;3;3;0.1;0.6;4288;2848;12212224;5194169;0;5194169;323767;323767;5194169;162
ISIC_0012547;350;4;2;0.1;0.6;4288;2848;12212224;11237182;111875;11237182;572681;460806;11349057;412
ISIC_0014428;350;1;3;100.0;0.6;4288;2848;12212224;1338154;6259;1338154;525860;519601;1344413;375
ISIC_0012547;100;1;1;0.01;0.6;4288;2848;12212224;0;572681;0;572681;0;572681;61
ISIC_0013082;150;4;1;0.01;0.6;3872;2592;10036224;2845885;0;2845885;254836;254836;2845885;166
ISIC_0014623;250;4;3;1.0;0.6;2592;1936;5018112;1086374;1046667;1086374;1937167;890500;2133041;298
ISIC_0014428;400;2;1;1.0;0.6;4288;2848;12212224;1045664;4632;1045664;525860;521228;1050296;438
ISIC_0014712;100;3;1;100.0;0.6;6621;4422;29278062;3327017;12431273;3327017;24292916;11861643;15758290;95
ISIC_0007332;250;2;2;0.01;0.6;3024;2016;6096384;5097804;5882;5097804;530766;524884;5103686;261
ISIC_0013082;100;4;2;10.0;0.6;3872;2592;10036224;2998462;0;2998462;254836;254836;2998462;114
ISIC_0007332;300;3;3;1.0;0.6;3024;2016;6096384;5088328;0;5088328;530766;530766;5088328;343
ISIC_0013188;50;3;3;1.0;0.6;3008;2000;6016000;5070646;0;5070646;92544;92544;5070646;43
ISIC_0012547;150;4;2;0.01;0.6;4288;2848;12212224;0;572681;0;572681;0;572681;171
ISIC_0008524;200;1;2;0.1;0.6;4288;2848;12212224;4904701;3180;4904701;323767;320587;4907881;187
ISIC_0013082;200;3;3;100.0;0.6;3872;2592;10036224;2123938;200;2123938;254836;254636;2124138;225
ISIC_0013188;400;4;2;100.0;0.6;3008;2000;6016000;3250048;0;3250048;92544;92544;3250048;475
ISIC_0014428;400;4;2;0.01;0.6;4288;2848;12212224;996783;23;996783;525860;525837;996806;471
ISIC_0008524;50;3;3;100.0;0.6;4288;2848;12212224;6380935;12029;6380935;323767;311738;6392964;45
ISIC_0014623;300;2;3;10.0;0.6;2592;1936;5018112;1114097;1061439;1114097;1937167;875728;2175536;329
ISIC_0014623;350;2;3;1.0;0.6;2592;1936;5018112;1095989;1040011;1095989;1937167;897156;2136000;388
ISIC_0014712;400;2;3;0.1;0.6;6621;4422;29278062;1285077;17748776;1285077;24292916;6544140;19033853;447
ISIC_0003657;150;3;2;0.01;0.6;3024;2016;6096384;1972716;19909;1972716;340261;320352;1992625;156
ISIC_0014623;350;3;1;100.0;0.6;2592;1936;5018112;1040230;1054447;1040230;1937167;882720;2094677;395
ISIC_0013128;400;1;3;0.1;0.6;3872;2592;10036224;4838354;0;4838354;470897;470897;4838354;432
ISIC_0014428;100;1;3;100.0;0.6;4288;2848;12212224;2634280;534;2634280;525860;525326;2634814;75
ISIC_0012547;250;3;2;1.0;0.6;4288;2848;12212224;11493851;0;11493851;572681;572681;11493851;278
ISIC_0013082;400;1;2;100.0;0.6;3872;2592;10036224;1809541;0;1809541;254836;254836;1809541;430
ISIC_0014712;50;2;2;0.01;0.6;6621;4422;29278062;3286469;11215189;3286469;24292916;13077727;14501658;21
ISIC_0014623;300;2;1;100.0;0.6;2592;1936;5018112;1113968;1061439;1113968;1937167;875728;2175407;320
ISIC_0014712;300;3;1;1.0;0.6;6621;4422;29278062;1314375;17477674;1314375;24292916;6815242;18792049;333
ISIC_0013082;150;3;1;1.0;0.6;3872;2592;10036224;2689772;2350;2689772;254836;252486;2692122;153
ISIC_0013188;250;1;3;10.0;0.6;3008;2000;6016000;3868087;0;3868087;92544;92544;3868087;254
ISIC_0014623;200;4;3;1.0;0.6;2592;1936;5018112;1160625;976585;1160625;1937167;960582;2137210;238
ISIC_0008524;300;1;3;100.0;0.6;4288;2848;12212224;4439756;4070;4439756;323767;319697;4443826;315
ISIC_0014623;450;4;1;10.0;0.6;2592;1936;5018112;875595;1217578;875595;1937167;719589;2093173;529
ISIC_0012547;350;4;1;10.0;0.6;4288;2848;12212224;11254071;106338;11254071;572681;466343;11360409;409
ISIC_0007332;50;1;1;1.0;0.6;3024;2016;6096384;5117656;0;5117656;530766;530766;5117656;3
ISIC_0014623;150;4;1;10.0;0.6;2592;1936;5018112;1308360;886998;1308360;1937167;1050169;2195358;169
ISIC_0014623;450;2;1;10.0;0.6;2592;1936;5018112;1000832;1111210;1000832;1937167;825957;2112042;499
ISIC_0013082;300;4;3;0.01;0.6;3872;2592;10036224;1839113;7451;1839113;254836;247385;1846564;356
ISIC_0013128;300;3;3;0.01;0.6;3872;2592;10036224;5146927;0;5146927;470897;470897;5146927;341
ISIC_0007332;400;2;3;100.0;0.6;3024;2016;6096384;4811754;0;4811754;530766;530766;4811754;450
ISIC_0012547;400;4;2;1.0;0.6;4288;2848;12212224;11135586;122500;11135586;572681;450181;11258086;473
ISIC_0014623;450;4;1;1.0;0.6;2592;1936;5018112;875650;1217539;875650;1937167;719628;2093189;528
ISIC_0013082;200;3;3;10.0;0.6;3872;2592;10036224;2123919;200;2123919;254836;254636;2124119;224
ISIC_0014623;350;2;1;1.0;0.6;2592;1936;5018112;1095766;1039772;1095766;1937167;897395;2135538;378
ISIC_0014712;400;3;3;100.0;0.6;6621;4422;29278062;1239199;17659384;1239199;24292916;6633532;18898583;465
ISIC_0003657;200;4;3;1.0;0.6;3024;2016;6096384;1693983;901;1693983;340261;339360;1694884;238
ISIC_0008524;200;4;3;100.0;0.6;4288;2848;12212224;3962511;11825;3962511;323767;311942;3974336;240
ISIC_0014428;400;1;3;100.0;0.6;4288;2848;12212224;1256533;1424;1256533;525860;524436;1257957;435
ISIC_0013082;250;2;2;100.0;0.6;3872;2592;10036224;2106430;0;2106430;254836;254836;2106430;265
ISIC_0014712;300;2;2;0.01;0.6;6621;4422;29278062;1420197;17182927;1420197;24292916;7109989;18603124;321
ISIC_0013188;200;1;3;0.01;0.6;3008;2000;6016000;4056593;359;4056593;92544;92185;4056952;191
ISIC_0013082;350;1;1;100.0;0.6;3872;2592;10036224;1955511;0;1955511;254836;254836;1955511;365
ISIC_0014428;150;1;1;100.0;0.6;4288;2848;12212224;2154405;990;2154405;525860;524870;2155395;125
ISIC_0013082;400;2;2;100.0;0.6;3872;2592;10036224;1809541;0;1809541;254836;254836;1809541;445
ISIC_0013082;300;1;1;0.1;0.6;3872;2592;10036224;2064966;0;2064966;254836;254836;2064966;302
ISIC_0014428;150;4;2;0.1;0.6;4288;2848;12212224;1505280;26444;1505280;525860;499416;1531724;172
ISIC_0007332;250;2;2;100.0;0.6;3024;2016;6096384;5174623;895;5174623;530766;529871;5175518;265
ISIC_0008524;450;3;2;100.0;0.6;4288;2848;12212224;3650397;18436;3650397;323767;305331;3668833;520
ISIC_0008524;400;3;2;0.1;0.6;4288;2848;12212224;3998097;3631;3998097;323767;320136;4001728;457
ISIC_0003657;150;2;3;0.1;0.6;3024;2016;6096384;2296610;0;2296610;340261;340261;2296610;147
ISIC_0003657;450;3;3;100.0;0.6;3024;2016;6096384;1411816;1807;1411816;340261;338454;1413623;525
ISIC_0008524;300;1;2;100.0;0.6;4288;2848;12212224;4439415;4070;4439415;323767;319697;4443485;310
ISIC_0014428;250;1;3;100.0;0.6;4288;2848;12212224;1469675;4628;1469675;525860;521232;1474303;255
ISIC_0014428;100;4;2;100.0;0.6;4288;2848;12212224;2370787;534;2370787;525860;525326;2371321;115
ISIC_0014623;350;4;3;10.0;0.6;2592;1936;5018112;960262;1144291;960262;1937167;792876;2104553;419
ISIC_0013128;50;3;3;10.0;0.6;3872;2592;10036224;6971275;0;6971275;470897;470897;6971275;44
ISIC_0013128;450;3;1;1.0;0.6;3872;2592;10036224;4621028;0;4621028;470897;470897;4621028;513
ISIC_0013128;50;4;1;100.0;0.6;3872;2592;10036224;6779125;0;6779125;470897;470897;6779125;50
ISIC_0013082;300;3;2;10.0;0.6;3872;2592;10036224;2200859;224;2200859;254836;254612;2201083;339
ISIC_0014428;250;4;2;0.1;0.6;4288;2848;12212224;1212144;0;1212144;525860;525860;1212144;292
ISIC_0013188;150;2;2;100.0;0.6;3008;2000;6016000;4477530;0;4477530;92544;92544;4477530;145
ISIC_0007332;400;2;3;0.01;0.6;3024;2016;6096384;4651726;13307;4651726;530766;517459;4665033;446
ISIC_0012547;200;3;3;10.0;0.6;4288;2848;12212224;11253200;0;11253200;572681;572681;11253200;224
ISIC_0013188;250;4;2;10.0;0.6;3008;2000;6016000;3820182;0;3820182;92544;92544;3820182;294
ISIC_0007332;100;3;2;10.0;0.6;3024;2016;6096384;0;530766;0;530766;0;530766;99
ISIC_0014428;150;2;3;10.0;0.6;4288;2848;12212224;2072040;990;2072040;525860;524870;2073030;149
ISIC_0014428;200;3;3;0.01;0.6;4288;2848;12212224;1370042;2917;1370042;525860;522943;1372959;221
ISIC_0012547;200;1;2;100.0;0.6;4288;2848;12212224;11252815;0;11252815;572681;572681;11252815;190
ISIC_0014428;450;2;2;0.01;0.6;4288;2848;12212224;905956;521;905956;525860;525339;906477;501
ISIC_0008524;350;2;3;1.0;0.6;4288;2848;12212224;4001159;4387;4001159;323767;319380;4005546;388
ISIC_0003657;200;1;3;100.0;0.6;3024;2016;6096384;2128317;304;2128317;340261;339957;2128621;195
ISIC_0007332;50;2;3;0.1;0.6;3024;2016;6096384;5241711;0;5241711;530766;530766;5241711;27
ISIC_0012547;200;3;1;0.01;0.6;4288;2848;12212224;11551831;0;11551831;572681;572681;11551831;211
ISIC_0013128;250;1;3;10.0;0.6;3872;2592;10036224;5441512;0;5441512;470897;470897;5441512;254
ISIC_0003657;200;4;3;100.0;0.6;3024;2016;6096384;1664668;1959;1664668;340261;338302;1666627;240
ISIC_0012547;200;2;2;10.0;0.6;4288;2848;12212224;11253560;0;11253560;572681;572681;11253560;204
ISIC_0014712;300;2;1;10.0;0.6;6621;4422;29278062;1318799;17086947;1318799;24292916;7205969;18405746;319
ISIC_0012547;50;2;3;1.0;0.6;4288;2848;12212224;10802068;0;10802068;572681;572681;10802068;28
ISIC_0014712;50;2;1;100.0;0.6;6621;4422;29278062;2464669;12862508;2464669;24292916;11430408;15327177;20
ISIC_0012547;450;1;1;100.0;0.6;4288;2848;12212224;11281493;0;11281493;572681;572681;11281493;485
ISIC_0012547;150;2;2;10.0;0.6;4288;2848;12212224;11558318;0;11558318;572681;572681;11558318;144
ISIC_0014712;200;1;3;1.0;0.6;6621;4422;29278062;1529685;14862215;1529685;24292916;9430701;16391900;193
ISIC_0014428;250;3;1;100.0;0.6;4288;2848;12212224;1366468;4628;1366468;525860;521232;1371096;275
ISIC_0014428;450;1;1;100.0;0.6;4288;2848;12212224;1237543;8163;1237543;525860;517697;1245706;485
ISIC_0014623;150;1;3;1.0;0.6;2592;1936;5018112;1601248;679586;1601248;1937167;1257581;2280834;133
ISIC_0012547;100;4;2;10.0;0.6;4288;2848;12212224;0;572681;0;572681;0;572681;114
ISIC_0013188;300;1;2;10.0;0.6;3008;2000;6016000;3696079;45;3696079;92544;92499;3696124;309
ISIC_0008524;450;4;2;0.01;0.6;4288;2848;12212224;2900901;2764;2900901;323767;321003;2903665;531
ISIC_0013128;400;3;3;1.0;0.6;3872;2592;10036224;4634370;0;4634370;470897;470897;4634370;463
ISIC_0008524;200;4;1;0.01;0.6;4288;2848;12212224;4341865;0;4341865;323767;323767;4341865;226
ISIC_0013188;250;4;3;1.0;0.6;3008;2000;6016000;3845977;0;3845977;92544;92544;3845977;298
ISIC_0008524;250;1;1;0.01;0.6;4288;2848;12212224;4784661;0;4784661;323767;323767;4784661;241
ISIC_0014428;250;3;3;0.1;0.6;4288;2848;12212224;1317494;0;1317494;525860;525860;1317494;282
ISIC_0014712;150;1;2;100.0;0.6;6621;4422;29278062;2009579;13809811;2009579;24292916;10483105;15819390;130
ISIC_0013082;350;1;3;0.01;0.6;3872;2592;10036224;1513449;12677;1513449;254836;242159;1526126;371
ISIC_0013188;50;4;3;10.0;0.6;3008;2000;6016000;4951107;0;4951107;92544;92544;4951107;59
ISIC_0013082;250;4;3;100.0;0.6;3872;2592;10036224;2106430;0;2106430;254836;254836;2106430;300
ISIC_0014712;450;4;3;0.01;0.6;6621;4422;29278062;923802;19036029;923802;24292916;5256887;19959831;536
ISIC_0007332;400;4;1;0.1;0.6;3024;2016;6096384;4634936;0;4634936;530766;530766;4634936;467
ISIC_0014428;250;1;1;100.0;0.6;4288;2848;12212224;1469675;4628;1469675;525860;521232;1474303;245
ISIC_0012547;400;2;3;10.0;0.6;4288;2848;12212224;11219541;0;11219541;572681;572681;11219541;449
ISIC_0013188;50;3;3;0.1;0.6;3008;2000;6016000;5403977;0;5403977;92544;92544;5403977;42
ISIC_0014623;450;2;2;10.0;0.6;2592;1936;5018112;1000764;1111209;1000764;1937167;825958;2111973;504
ISIC_0014712;350;3;3;0.01;0.6;6621;4422;29278062;1034286;17759412;1034286;24292916;6533504;18793698;401
ISIC_0013128;400;3;3;0.1;0.6;3872;2592;10036224;4738380;0;4738380;470897;470897;4738380;462
ISIC_0013128;250;2;2;100.0;0.6;3872;2592;10036224;5441794;0;5441794;470897;470897;5441794;265
ISIC_0003657;450;4;1;10.0;0.6;3024;2016;6096384;1372642;1807;1372642;340261;338454;1374449;529
ISIC_0014428;150;2;1;0.01;0.6;4288;2848;12212224;2141971;0;2141971;525860;525860;2141971;136
ISIC_0013188;100;2;3;1.0;0.6;3008;2000;6016000;4800318;0;4800318;92544;92544;4800318;88
ISIC_0012547;200;3;1;10.0;0.6;4288;2848;12212224;11253106;0;11253106;572681;572681;11253106;214
ISIC_0008524;450;2;3;100.0;0.6;4288;2848;12212224;3870647;18436;3870647;323767;305331;3889083;510
ISIC_0013188;350;2;1;1.0;0.6;3008;2000;6016000;3507908;0;3507908;92544;92544;3507908;378
ISIC_0012547;400;3;3;100.0;0.6;4288;2848;12212224;11191891;61250;11191891;572681;511431;11253141;465
ISIC_0007332;100;3;3;0.01;0.6;3024;2016;6096384;0;530766;0;530766;0;530766;101
ISIC_0008524;400;3;2;10.0;0.6;4288;2848;12212224;3931562;13085;3931562;323767;310682;3944647;459
ISIC_0008524;150;1;3;1.0;0.6;4288;2848;12212224;5141649;2624;5141649;323767;321143;5144273;133
ISIC_0012547;300;2;1;0.1;0.6;4288;2848;12212224;11418809;0;11418809;572681;572681;11418809;317
ISIC_0014712;250;4;2;0.1;0.6;6621;4422;29278062;1787307;17968384;1787307;24292916;6324532;19755691;292
ISIC_0003657;250;1;3;1.0;0.6;3024;2016;6096384;2033787;389;2033787;340261;339872;2034176;253
ISIC_0007332;100;4;2;0.1;0.6;3024;2016;6096384;0;530766;0;530766;0;530766;112
ISIC_0012547;450;3;2;0.1;0.6;4288;2848;12212224;11208409;57363;11208409;572681;515318;11265772;517
ISIC_0003657;200;4;2;0.1;0.6;3024;2016;6096384;1809533;0;1809533;340261;340261;1809533;232
ISIC_0007332;250;4;3;0.01;0.6;3024;2016;6096384;5095238;0;5095238;530766;530766;5095238;296
ISIC_0008524;150;3;1;100.0;0.6;4288;2848;12212224;4910871;5649;4910871;323767;318118;4916520;155
ISIC_0008524;350;1;2;0.01;0.6;4288;2848;12212224;4455037;5164;4455037;323767;318603;4460201;366
ISIC_0013188;400;4;3;10.0;0.6;3008;2000;6016000;3249980;0;3249980;92544;92544;3249980;479
ISIC_0008524;100;2;3;100.0;0.6;4288;2848;12212224;5531675;4774;5531675;323767;318993;5536449;90
ISIC_0014623;250;2;3;100.0;0.6;2592;1936;5018112;1266686;966718;1266686;1937167;970449;2233404;270
ISIC_0007332;400;4;2;0.01;0.6;3024;2016;6096384;4722282;10066;4722282;530766;520700;4732348;471
ISIC_0013128;350;2;3;10.0;0.6;3872;2592;10036224;4995953;0;4995953;470897;470897;4995953;389
ISIC_0007332;300;3;1;0.1;0.6;3024;2016;6096384;4986258;0;4986258;530766;530766;4986258;332
ISIC_0003657;450;4;2;1.0;0.6;3024;2016;6096384;1372828;1871;1372828;340261;338390;1374699;533
ISIC_0007332;200;1;2;0.1;0.6;3024;2016;6096384;5210543;0;5210543;530766;530766;5210543;187
ISIC_0003657;50;1;3;0.1;0.6;3024;2016;6096384;3743372;571;3743372;340261;339690;3743943;12
ISIC_0012547;400;2;1;100.0;0.6;4288;2848;12212224;11219541;0;11219541;572681;572681;11219541;440
ISIC_0013188;100;4;1;1.0;0.6;3008;2000;6016000;4737774;0;4737774;92544;92544;4737774;108
ISIC_0013128;400;3;3;100.0;0.6;3872;2592;10036224;4609421;0;4609421;470897;470897;4609421;465
ISIC_0003657;50;1;1;0.01;0.6;3024;2016;6096384;4198023;0;4198023;340261;340261;4198023;1
ISIC_0013128;200;1;2;1.0;0.6;3872;2592;10036224;5712137;0;5712137;470897;470897;5712137;188
ISIC_0008524;350;1;3;100.0;0.6;4288;2848;12212224;4242442;277;4242442;323767;323490;4242719;375
ISIC_0014712;450;1;2;1.0;0.6;6621;4422;29278062;1065521;17255451;1065521;24292916;7037465;18320972;488
ISIC_0003657;450;1;3;1.0;0.6;3024;2016;6096384;1707138;741;1707138;340261;339520;1707879;493
ISIC_0014428;250;4;2;10.0;0.6;4288;2848;12212224;1317627;4628;1317627;525860;521232;1322255;294
ISIC_0014623;200;1;1;1.0;0.6;2592;1936;5018112;1415554;742979;1415554;1937167;1194188;2158533;183
ISIC_0013188;100;4;3;0.1;0.6;3008;2000;6016000;4862204;0;4862204;92544;92544;4862204;117
ISIC_0003657;200;1;2;10.0;0.6;3024;2016;6096384;2128298;304;2128298;340261;339957;2128602;189
ISIC_0014428;450;3;2;0.1;0.6;4288;2848;12212224;807629;0;807629;525860;525860;807629;517
ISIC_0014623;300;4;2;0.01;0.6;2592;1936;5018112;1003967;1097815;1003967;1937167;839352;2101782;351
ISIC_0007332;50;4;3;100.0;0.6;3024;2016;6096384;5150108;0;5150108;530766;530766;5150108;60
ISIC_0013188;300;2;2;10.0;0.6;3008;2000;6016000;3696079;45;3696079;92544;92499;3696124;324
ISIC_0013188;250;4;1;10.0;0.6;3008;2000;6016000;3820281;0;3820281;92544;92544;3820281;289
ISIC_0014428;250;4;1;1.0;0.6;4288;2848;12212224;1315232;0;1315232;525860;525860;1315232;288
ISIC_0008524;400;3;1;0.1;0.6;4288;2848;12212224;3966041;3691;3966041;323767;320076;3969732;452
ISIC_0013128;150;2;1;0.1;0.6;3872;2592;10036224;5798660;0;5798660;470897;470897;5798660;137
ISIC_0012547;350;2;2;10.0;0.6;4288;2848;12212224;11254076;36400;11254076;572681;536281;11290476;384
ISIC_0014712;450;1;1;0.01;0.6;6621;4422;29278062;1134360;16839076;1134360;24292916;7453840;17973436;481
ISIC_0014712;150;4;1;0.1;0.6;6621;4422;29278062;1742329;16383762;1742329;24292916;7909154;18126091;167
ISIC_0013128;400;2;1;1.0;0.6;3872;2592;10036224;4632672;0;4632672;470897;470897;4632672;438
ISIC_0014712;50;4;3;0.1;0.6;6621;4422;29278062;2254396;13802778;2254396;24292916;10490138;16057174;57
ISIC_0014623;50;2;3;10.0;0.6;2592;1936;5018112;2054786;437312;2054786;1937167;1499855;2492098;29
ISIC_0003657;450;2;3;10.0;0.6;3024;2016;6096384;1551054;1807;1551054;340261;338454;1552861;509
ISIC_0014623;200;1;2;1.0;0.6;2592;1936;5018112;1415555;742968;1415555;1937167;1194199;2158523;188
ISIC_0013188;100;3;3;1.0;0.6;3008;2000;6016000;4800663;0;4800663;92544;92544;4800663;103
ISIC_0007332;100;2;1;0.1;0.6;3024;2016;6096384;0;530766;0;530766;0;530766;77
ISIC_0007332;450;4;2;1.0;0.6;3024;2016;6096384;4640789;83;4640789;530766;530683;4640872;533
ISIC_0014428;450;2;2;0.1;0.6;4288;2848;12212224;870899;0;870899;525860;525860;870899;502
ISIC_0003657;100;1;1;1.0;0.6;3024;2016;6096384;2754799;879;2754799;340261;339382;2755678;63
ISIC_0003657;150;1;3;0.1;0.6;3024;2016;6096384;2411931;0;2411931;340261;340261;2411931;132
ISIC_0014428;100;4;1;1.0;0.6;4288;2848;12212224;2245778;9190;2245778;525860;516670;2254968;108
ISIC_0007332;200;4;1;100.0;0.6;3024;2016;6096384;5168994;0;5168994;530766;530766;5168994;230
ISIC_0013188;100;3;1;0.1;0.6;3008;2000;6016000;4927509;0;4927509;92544;92544;4927509;92
ISIC_0013128;100;2;2;0.01;0.6;3872;2592;10036224;6727248;0;6727248;470897;470897;6727248;81
ISIC_0008524;150;4;3;0.01;0.6;4288;2848;12212224;4554555;18708;4554555;323767;305059;4573263;176
ISIC_0012547;250;1;1;1.0;0.6;4288;2848;12212224;11493518;0;11493518;572681;572681;11493518;243
ISIC_0014623;50;1;2;0.1;0.6;2592;1936;5018112;2417160;427600;2417160;1937167;1509567;2844760;7
ISIC_0014428;400;2;3;1.0;0.6;4288;2848;12212224;1045921;4599;1045921;525860;521261;1050520;448
ISIC_0013082;250;4;2;0.1;0.6;3872;2592;10036224;1929943;9508;1929943;254836;245328;1939451;292
ISIC_0008524;400;1;1;0.01;0.6;4288;2848;12212224;4283756;1409;4283756;323767;322358;4285165;421
ISIC_0014712;250;2;2;100.0;0.6;6621;4422;29278062;1784642;16828953;1784642;24292916;7463963;18613595;265
ISIC_0013082;200;2;2;1.0;0.6;3872;2592;10036224;2130272;483;2130272;254836;254353;2130755;203
ISIC_0014428;300;2;1;100.0;0.6;4288;2848;12212224;1252278;1843;1252278;525860;524017;1254121;320
ISIC_0013188;250;2;3;10.0;0.6;3008;2000;6016000;3844062;0;3844062;92544;92544;3844062;269
ISIC_0003657;100;2;3;10.0;0.6;3024;2016;6096384;2565402;30;2565402;340261;340231;2565432;89
ISIC_0003657;50;3;1;100.0;0.6;3024;2016;6096384;2192243;72;2192243;340261;340189;2192315;35
ISIC_0014428;50;1;3;100.0;0.6;4288;2848;12212224;2715317;1211;2715317;525860;524649;2716528;15
ISIC_0008524;400;3;3;0.01;0.6;4288;2848;12212224;3800991;11171;3800991;323767;312596;3812162;461
ISIC_0013082;50;1;3;0.1;0.6;3872;2592;10036224;3865651;2202;3865651;254836;252634;3867853;12
ISIC_0014623;400;4;2;0.01;0.6;2592;1936;5018112;944427;1202329;944427;1937167;734838;2146756;471
ISIC_0013188;50;4;3;100.0;0.6;3008;2000;6016000;4950975;0;4950975;92544;92544;4950975;60
ISIC_0012547;200;2;3;0.01;0.6;4288;2848;12212224;11546954;0;11546954;572681;572681;11546954;206
ISIC_0014428;350;3;1;100.0;0.6;4288;2848;12212224;1232873;6259;1232873;525860;519601;1239132;395
ISIC_0014623;100;4;1;10.0;0.6;2592;1936;5018112;1534120;767826;1534120;1937167;1169341;2301946;109
ISIC_0013128;50;4;3;100.0;0.6;3872;2592;10036224;6779095;0;6779095;470897;470897;6779095;60
ISIC_0013128;50;1;3;10.0;0.6;3872;2592;10036224;6971246;0;6971246;470897;470897;6971246;14
ISIC_0007332;350;3;3;1.0;0.6;3024;2016;6096384;4872135;0;4872135;530766;530766;4872135;403
ISIC_0013128;350;4;1;0.1;0.6;3872;2592;10036224;4790752;0;4790752;470897;470897;4790752;407
ISIC_0013082;450;2;1;10.0;0.6;3872;2592;10036224;1722792;1608;1722792;254836;253228;1724400;499
ISIC_0007332;150;1;1;10.0;0.6;3024;2016;6096384;5525218;0;5525218;530766;530766;5525218;124
ISIC_0012547;150;1;1;100.0;0.6;4288;2848;12212224;11558318;0;11558318;572681;572681;11558318;125
ISIC_0014428;300;4;2;0.1;0.6;4288;2848;12212224;1179111;1211;1179111;525860;524649;1180322;352
ISIC_0014623;300;2;2;1.0;0.6;2592;1936;5018112;1114098;1061439;1114098;1937167;875728;2175537;323
ISIC_0014623;250;4;1;0.01;0.6;2592;1936;5018112;1043091;974856;1043091;1937167;962311;2017947;286
ISIC_0008524;200;3;3;0.1;0.6;4288;2848;12212224;4794504;3242;4794504;323767;320525;4797746;222
ISIC_0013188;200;2;1;0.1;0.6;3008;2000;6016000;4091635;0;4091635;92544;92544;4091635;197
ISIC_0008524;100;4;3;0.01;0.6;4288;2848;12212224;5565021;26071;5565021;323767;297696;5591092;116
ISIC_0007332;200;4;1;0.1;0.6;3024;2016;6096384;5189181;0;5189181;530766;530766;5189181;227
ISIC_0014428;250;3;3;0.01;0.6;4288;2848;12212224;1173625;17474;1173625;525860;508386;1191099;281
ISIC_0013188;250;2;1;10.0;0.6;3008;2000;6016000;3820281;0;3820281;92544;92544;3820281;259
ISIC_0013082;300;3;3;0.1;0.6;3872;2592;10036224;1923390;7441;1923390;254836;247395;1930831;342
ISIC_0003657;200;4;2;10.0;0.6;3024;2016;6096384;1637361;1959;1637361;340261;338302;1639320;234
ISIC_0013188;350;2;2;0.1;0.6;3008;2000;6016000;3320080;0;3320080;92544;92544;3320080;382
ISIC_0013082;150;1;2;10.0;0.6;3872;2592;10036224;2759695;183;2759695;254836;254653;2759878;129
ISIC_0014712;400;4;2;10.0;0.6;6621;4422;29278062;1232291;18911029;1232291;24292916;5381887;20143320;474
ISIC_0014428;250;2;1;0.01;0.6;4288;2848;12212224;1523961;0;1523961;525860;525860;1523961;256
ISIC_0013082;400;3;1;0.1;0.6;3872;2592;10036224;1563301;0;1563301;254836;254836;1563301;452
ISIC_0013082;300;3;2;0.01;0.6;3872;2592;10036224;2002207;2493;2002207;254836;252343;2004700;336
ISIC_0003657;250;3;3;0.01;0.6;3024;2016;6096384;1700150;14971;1700150;340261;325290;1715121;281
ISIC_0012547;350;2;3;0.1;0.6;4288;2848;12212224;11231377;0;11231377;572681;572681;11231377;387
ISIC_0007332;100;3;2;100.0;0.6;3024;2016;6096384;0;530766;0;530766;0;530766;100
ISIC_0003657;450;1;1;10.0;0.6;3024;2016;6096384;1694938;1807;1694938;340261;338454;1696745;484
ISIC_0003657;300;2;2;0.01;0.6;3024;2016;6096384;1799711;12492;1799711;340261;327769;1812203;321
ISIC_0008524;150;4;2;0.01;0.6;4288;2848;12212224;4547789;19140;4547789;323767;304627;4566929;171
ISIC_0003657;450;2;3;0.01;0.6;3024;2016;6096384;1574838;14369;1574838;340261;325892;1589207;506
ISIC_0014428;50;1;3;10.0;0.6;4288;2848;12212224;2715583;1211;2715583;525860;524649;2716794;14
ISIC_0008524;50;2;3;10.0;0.6;4288;2848;12212224;6156984;12092;6156984;323767;311675;6169076;29
ISIC_0012547;150;1;1;10.0;0.6;4288;2848;12212224;11558318;0;11558318;572681;572681;11558318;124
ISIC_0014712;350;3;3;1.0;0.6;6621;4422;29278062;1248798;17166612;1248798;24292916;7126304;18415410;403
ISIC_0014623;300;2;2;0.01;0.6;2592;1936;5018112;1095420;1066338;1095420;1937167;870829;2161758;321
ISIC_0014623;400;3;2;0.01;0.6;2592;1936;5018112;1032597;1104979;1032597;1937167;832188;2137576;456
ISIC_0012547;350;3;2;0.01;0.6;4288;2848;12212224;11466402;87585;11466402;572681;485096;11553987;396
ISIC_0007332;100;1;3;10.0;0.6;3024;2016;6096384;0;530766;0;530766;0;530766;74
ISIC_0003657;50;3;2;10.0;0.6;3024;2016;6096384;2191889;72;2191889;340261;340189;2191961;39
ISIC_0013082;450;3;2;0.1;0.6;3872;2592;10036224;1507053;1608;1507053;254836;253228;1508661;517
ISIC_0008524;50;3;3;1.0;0.6;4288;2848;12212224;6142352;14099;6142352;323767;309668;6156451;43
ISIC_0014712;100;2;3;100.0;0.6;6621;4422;29278062;3327019;12127753;3327019;24292916;12165163;15454772;90
ISIC_0014712;200;3;3;0.01;0.6;6621;4422;29278062;1649994;16213591;1649994;24292916;8079325;17863585;221
ISIC_0014712;50;3;1;0.01;0.6;6621;4422;29278062;3301061;11172913;3301061;24292916;13120003;14473974;31
ISIC_0007332;150;4;2;100.0;0.6;3024;2016;6096384;5525218;0;5525218;530766;530766;5525218;175
ISIC_0014623;50;3;1;0.01;0.6;2592;1936;5018112;2210185;452238;2210185;1937167;1484929;2662423;31
ISIC_0007332;150;4;3;0.1;0.6;3024;2016;6096384;5482164;0;5482164;530766;530766;5482164;177
ISIC_0003657;450;2;2;1.0;0.6;3024;2016;6096384;1551001;1871;1551001;340261;338390;1552872;503
ISIC_0014712;350;2;1;10.0;0.6;6621;4422;29278062;1252247;17088115;1252247;24292916;7204801;18340362;379
ISIC_0014712;150;2;2;100.0;0.6;6621;4422;29278062;1997847;15165184;1997847;24292916;9127732;17163031;145
ISIC_0003657;450;2;3;100.0;0.6;3024;2016;6096384;1551054;1807;1551054;340261;338454;1552861;510
ISIC_0013188;150;4;2;0.01;0.6;3008;2000;6016000;4508600;0;4508600;92544;92544;4508600;171
ISIC_0013128;300;3;2;1.0;0.6;3872;2592;10036224;5070824;55;5070824;470897;470842;5070879;338
ISIC_0014623;350;2;2;10.0;0.6;2592;1936;5018112;1096107;1040131;1096107;1937167;897036;2136238;384
ISIC_0013082;450;4;1;100.0;0.6;3872;2592;10036224;1722804;1608;1722804;254836;253228;1724412;530
ISIC_0012547;100;3;3;100.0;0.6;4288;2848;12212224;0;572681;0;572681;0;572681;105
ISIC_0012547;200;2;3;0.1;0.6;4288;2848;12212224;11512909;0;11512909;572681;572681;11512909;207
ISIC_0014623;100;4;3;100.0;0.6;2592;1936;5018112;1496825;767923;1496825;1937167;1169244;2264748;120
ISIC_0013188;200;2;1;10.0;0.6;3008;2000;6016000;4007583;0;4007583;92544;92544;4007583;199
ISIC_0008524;350;1;3;0.1;0.6;4288;2848;12212224;4293296;98;4293296;323767;323669;4293394;372
ISIC_0007332;400;3;2;0.01;0.6;3024;2016;6096384;4747154;0;4747154;530766;530766;4747154;456
ISIC_0014712;200;3;2;100.0;0.6;6621;4422;29278062;1404141;16368494;1404141;24292916;7924422;17772635;220
ISIC_0013188;400;2;3;0.01;0.6;3008;2000;6016000;3129355;1381;3129355;92544;91163;3130736;446
ISIC_0014623;450;2;2;0.1;0.6;2592;1936;5018112;967048;1120983;967048;1937167;816184;2088031;502
ISIC_0013082;300;2;3;0.01;0.6;3872;2592;10036224;1763631;7956;1763631;254836;246880;1771587;326
ISIC_0013128;150;1;1;100.0;0.6;3872;2592;10036224;5946325;0;5946325;470897;470897;5946325;125
ISIC_0014712;100;4;3;1.0;0.6;6621;4422;29278062;3327004;14542383;3327004;24292916;9750533;17869387;118
ISIC_0014712;350;3;1;0.1;0.6;6621;4422;29278062;1128055;17444246;1128055;24292916;6848670;18572301;392
ISIC_0013082;350;1;3;10.0;0.6;3872;2592;10036224;1955525;0;1955525;254836;254836;1955525;374
ISIC_0003657;50;2;1;100.0;0.6;3024;2016;6096384;2534936;72;2534936;340261;340189;2535008;20
ISIC_0012547;350;3;3;1.0;0.6;4288;2848;12212224;11254439;71369;11254439;572681;501312;11325808;403
ISIC_0014428;100;2;3;0.01;0.6;4288;2848;12212224;2392785;7577;2392785;525860;518283;2400362;86
ISIC_0008524;400;3;2;100.0;0.6;4288;2848;12212224;3931562;13085;3931562;323767;310682;3944647;460
ISIC_0014712;350;3;2;10.0;0.6;6621;4422;29278062;1248110;17167654;1248110;24292916;7125262;18415764;399
ISIC_0012547;350;3;3;0.01;0.6;4288;2848;12212224;11372602;88249;11372602;572681;484432;11460851;401
ISIC_0014712;250;2;1;0.1;0.6;6621;4422;29278062;1787901;16809939;1787901;24292916;7482977;18597840;257
ISIC_0014428;200;4;2;0.01;0.6;4288;2848;12212224;1614962;0;1614962;525860;525860;1614962;231
ISIC_0014623;100;1;2;100.0;0.6;2592;1936;5018112;1678088;581076;1678088;1937167;1356091;2259164;70
ISIC_0003657;300;2;3;10.0;0.6;3024;2016;6096384;1706607;2337;1706607;340261;337924;1708944;329
ISIC_0013128;300;1;1;10.0;0.6;3872;2592;10036224;5178423;39;5178423;470897;470858;5178462;304
ISIC_0014712;350;4;3;0.01;0.6;6621;4422;29278062;1038221;18816969;1038221;24292916;5475947;19855190;416
ISIC_0012547;150;2;2;0.1;0.6;4288;2848;12212224;11548573;0;11548573;572681;572681;11548573;142
ISIC_0013188;200;1;2;0.1;0.6;3008;2000;6016000;3996050;0;3996050;92544;92544;3996050;187
ISIC_0007332;200;2;2;1.0;0.6;3024;2016;6096384;5164026;0;5164026;530766;530766;5164026;203
ISIC_0014623;300;3;3;10.0;0.6;2592;1936;5018112;1080816;1094721;1080816;1937167;842446;2175537;344
ISIC_0012547;350;1;3;0.1;0.6;4288;2848;12212224;11262556;0;11262556;572681;572681;11262556;372
ISIC_0014623;450;2;3;0.1;0.6;2592;1936;5018112;981672;1119695;981672;1937167;817472;2101367;507
ISIC_0014712;100;4;2;10.0;0.6;6621;4422;29278062;3327050;14542524;3327050;24292916;9750392;17869574;114
ISIC_0014712;300;4;1;100.0;0.6;6621;4422;29278062;1314374;18365158;1314374;24292916;5927758;19679532;350
ISIC_0003657;450;3;2;0.01;0.6;3024;2016;6096384;1504820;14883;1504820;340261;325378;1519703;516
ISIC_0014623;100;3;2;10.0;0.6;2592;1936;5018112;1579324;719447;1579324;1937167;1217720;2298771;99
ISIC_0007332;50;1;2;10.0;0.6;3024;2016;6096384;5142939;0;5142939;530766;530766;5142939;9
ISIC_0007332;250;3;1;1.0;0.6;3024;2016;6096384;5150307;895;5150307;530766;529871;5151202;273
ISIC_0013188;50;4;2;0.01;0.6;3008;2000;6016000;5535198;0;5535198;92544;92544;5535198;51
ISIC_0013188;100;4;2;0.1;0.6;3008;2000;6016000;4861508;0;4861508;92544;92544;4861508;112
ISIC_0007332;400;1;1;0.1;0.6;3024;2016;6096384;4697467;5274;4697467;530766;525492;4702741;422
ISIC_0012547;50;1;2;10.0;0.6;4288;2848;12212224;10812136;0;10812136;572681;572681;10812136;9
ISIC_0013188;300;3;2;0.01;0.6;3008;2000;6016000;3790037;0;3790037;92544;92544;3790037;336
ISIC_0013188;400;2;2;0.01;0.6;3008;2000;6016000;3228687;293;3228687;92544;92251;3228980;441
ISIC_0014428;250;3;1;10.0;0.6;4288;2848;12212224;1366468;4628;1366468;525860;521232;1371096;274
ISIC_0003657;50;1;3;10.0;0.6;3024;2016;6096384;2883872;72;2883872;340261;340189;2883944;14
ISIC_0013128;150;1;1;1.0;0.6;3872;2592;10036224;5946068;0;5946068;470897;470897;5946068;123
ISIC_0012547;200;3;2;0.1;0.6;4288;2848;12212224;11513684;0;11513684;572681;572681;11513684;217
ISIC_0012547;100;1;3;0.1;0.6;4288;2848;12212224;0;572681;0;572681;0;572681;72
ISIC_0007332;250;1;3;1.0;0.6;3024;2016;6096384;5174641;895;5174641;530766;529871;5175536;253
ISIC_0013188;100;2;1;0.1;0.6;3008;2000;6016000;4861390;0;4861390;92544;92544;4861390;77
ISIC_0014623;450;4;2;100.0;0.6;2592;1936;5018112;875633;1217578;875633;1937167;719589;2093211;535
ISIC_0013128;250;1;3;1.0;0.6;3872;2592;10036224;5441493;0;5441493;470897;470897;5441493;253
ISIC_0014623;250;4;2;10.0;0.6;2592;1936;5018112;1086093;1047121;1086093;1937167;890046;2133214;294
ISIC_0013188;350;4;2;1.0;0.6;3008;2000;6016000;3508076;0;3508076;92544;92544;3508076;413
ISIC_0008524;350;4;1;0.01;0.6;4288;2848;12212224;3375188;1714;3375188;323767;322053;3376902;406
ISIC_0013082;400;1;1;0.1;0.6;3872;2592;10036224;1519548;0;1519548;254836;254836;1519548;422
ISIC_0013082;400;4;3;0.01;0.6;3872;2592;10036224;1354145;12734;1354145;254836;242102;1366879;476
ISIC_0014623;100;2;3;0.01;0.6;2592;1936;5018112;1642923;636605;1642923;1937167;1300562;2279528;86
ISIC_0013128;350;3;3;10.0;0.6;3872;2592;10036224;4845079;0;4845079;470897;470897;4845079;404
ISIC_0003657;400;1;3;0.1;0.6;3024;2016;6096384;1811728;0;1811728;340261;340261;1811728;432
ISIC_0013128;250;2;2;1.0;0.6;3872;2592;10036224;5441722;0;5441722;470897;470897;5441722;263
ISIC_0013128;50;3;1;0.01;0.6;3872;2592;10036224;7691072;0;7691072;470897;470897;7691072;31
ISIC_0013082;400;4;2;1.0;0.6;3872;2592;10036224;1814116;0;1814116;254836;254836;1814116;473
ISIC_0014623;100;3;2;100.0;0.6;2592;1936;5018112;1579324;719447;1579324;1937167;1217720;2298771;100
ISIC_0003657;300;3;1;0.01;0.6;3024;2016;6096384;1773647;1096;1773647;340261;339165;1774743;331
ISIC_0008524;450;4;1;0.1;0.6;4288;2848;12212224;2844774;8697;2844774;323767;315070;2853471;527
ISIC_0007332;300;3;2;100.0;0.6;3024;2016;6096384;5108872;0;5108872;530766;530766;5108872;340
ISIC_0014428;400;3;1;10.0;0.6;4288;2848;12212224;1108993;2798;1108993;525860;523062;1111791;454
ISIC_0007332;450;1;2;10.0;0.6;3024;2016;6096384;4697322;83;4697322;530766;530683;4697405;489
ISIC_0007332;400;2;2;0.01;0.6;3024;2016;6096384;4706887;16672;4706887;530766;514094;4723559;441
ISIC_0008524;250;3;3;10.0;0.6;4288;2848;12212224;4328397;7441;4328397;323767;316326;4335838;284
ISIC_0014428;50;2;2;0.01;0.6;4288;2848;12212224;3344121;3182;3344121;525860;522678;3347303;21
ISIC_0013128;200;1;3;1.0;0.6;3872;2592;10036224;5712123;0;5712123;470897;470897;5712123;193
ISIC_0012547;450;4;2;100.0;0.6;4288;2848;12212224;11029056;108900;11029056;572681;463781;11137956;535
ISIC_0014623;200;2;2;10.0;0.6;2592;1936;5018112;1310988;843830;1310988;1937167;1093337;2154818;204
ISIC_0014712;100;1;1;1.0;0.6;6621;4422;29278062;3652051;10958893;3652051;24292916;13334023;14610944;63
ISIC_0007332;400;4;2;100.0;0.6;3024;2016;6096384;4766918;0;4766918;530766;530766;4766918;475
ISIC_0003657;300;3;2;1.0;0.6;3024;2016;6096384;1582257;2490;1582257;340261;337771;1584747;338
ISIC_0014428;100;4;1;100.0;0.6;4288;2848;12212224;2370787;534;2370787;525860;525326;2371321;110
ISIC_0014712;250;3;2;100.0;0.6;6621;4422;29278062;1784642;17065959;1784642;24292916;7226957;18850601;280
ISIC_0007332;450;3;3;100.0;0.6;3024;2016;6096384;4683750;83;4683750;530766;530683;4683833;525
ISIC_0003657;450;2;2;100.0;0.6;3024;2016;6096384;1551054;1807;1551054;340261;338454;1552861;505
ISIC_0012547;350;3;1;100.0;0.6;4288;2848;12212224;11254071;71369;11254071;572681;501312;11325440;395
ISIC_0013188;250;3;1;1.0;0.6;3008;2000;6016000;3797348;0;3797348;92544;92544;3797348;273
ISIC_0014428;450;4;3;10.0;0.6;4288;2848;12212224;1128313;8163;1128313;525860;517697;1136476;539
ISIC_0013188;250;3;3;0.01;0.6;3008;2000;6016000;3914989;1153;3914989;92544;91391;3916142;281
ISIC_0014623;350;1;2;1.0;0.6;2592;1936;5018112;1163367;923033;1163367;1937167;1014134;2086400;368
ISIC_0013188;400;2;3;100.0;0.6;3008;2000;6016000;3250018;0;3250018;92544;92544;3250018;450
ISIC_0012547;150;1;3;100.0;0.6;4288;2848;12212224;11558318;0;11558318;572681;572681;11558318;135
ISIC_0014623;150;2;1;0.1;0.6;2592;1936;5018112;1609057;732044;1609057;1937167;1205123;2341101;137
ISIC_0012547;350;1;3;100.0;0.6;4288;2848;12212224;11289047;36400;11289047;572681;536281;11325447;375
ISIC_0014712;450;1;1;10.0;0.6;6621;4422;29278062;1065557;17186282;1065557;24292916;7106634;18251839;484
ISIC_0014623;350;1;2;10.0;0.6;2592;1936;5018112;1183119;941062;1183119;1937167;996105;2124181;369
ISIC_0013188;200;4;2;1.0;0.6;3008;2000;6016000;4028908;0;4028908;92544;92544;4028908;233
ISIC_0014712;300;4;2;0.1;0.6;6621;4422;29278062;1360325;18766040;1360325;24292916;5526876;20126365;352
ISIC_0014428;200;2;1;10.0;0.6;4288;2848;12212224;1500185;999;1500185;525860;524861;1501184;199
ISIC_0007332;100;1;1;1.0;0.6;3024;2016;6096384;0;530766;0;530766;0;530766;63
ISIC_0014428;200;2;3;10.0;0.6;4288;2848;12212224;1500185;999;1500185;525860;524861;1501184;209
ISIC_0013188;100;3;3;0.01;0.6;3008;2000;6016000;4871805;0;4871805;92544;92544;4871805;101
ISIC_0014428;50;1;1;10.0;0.6;4288;2848;12212224;2715609;1211;2715609;525860;524649;2716820;4
ISIC_0013188;100;2;3;100.0;0.6;3008;2000;6016000;4801204;0;4801204;92544;92544;4801204;90
ISIC_0014428;450;1;2;10.0;0.6;4288;2848;12212224;1237543;8163;1237543;525860;517697;1245706;489
ISIC_0008524;300;3;2;0.01;0.6;4288;2848;12212224;4480263;16;4480263;323767;323751;4480279;336
ISIC_0012547;350;2;1;1.0;0.6;4288;2848;12212224;11254272;36535;11254272;572681;536146;11290807;378
ISIC_0008524;350;3;1;1.0;0.6;4288;2848;12212224;4101911;5288;4101911;323767;318479;4107199;393
ISIC_0007332;450;3;3;0.01;0.6;3024;2016;6096384;4581269;0;4581269;530766;530766;4581269;521
ISIC_0007332;450;4;2;100.0;0.6;3024;2016;6096384;4640900;83;4640900;530766;530683;4640983;535
ISIC_0013082;450;1;2;0.1;0.6;3872;2592;10036224;1570020;1632;1570020;254836;253204;1571652;487
ISIC_0014428;100;4;1;0.01;0.6;4288;2848;12212224;2493772;0;2493772;525860;525860;2493772;106
ISIC_0014428;150;3;2;0.01;0.6;4288;2848;12212224;1976597;0;1976597;525860;525860;1976597;156
ISIC_0014623;150;1;1;100.0;0.6;2592;1936;5018112;1630442;679567;1630442;1937167;1257600;2310009;125
ISIC_0003657;200;1;2;1.0;0.6;3024;2016;6096384;2128535;391;2128535;340261;339870;2128926;188
ISIC_0014428;50;2;1;0.1;0.6;4288;2848;12212224;3036724;0;3036724;525860;525860;3036724;17
ISIC_0003657;150;1;1;0.01;0.6;3024;2016;6096384;2672373;0;2672373;340261;340261;2672373;121
ISIC_0013188;250;1;2;10.0;0.6;3008;2000;6016000;3844207;0;3844207;92544;92544;3844207;249
ISIC_0013082;400;4;2;0.01;0.6;3872;2592;10036224;1553035;84;1553035;254836;254752;1553119;471
ISIC_0014428;350;1;2;0.1;0.6;4288;2848;12212224;1169288;0;1169288;525860;525860;1169288;367
ISIC_0003657;150;3;2;100.0;0.6;3024;2016;6096384;2093523;1986;2093523;340261;338275;2095509;160
ISIC_0014712;150;4;2;0.1;0.6;6621;4422;29278062;1742430;16577100;1742430;24292916;7715816;18319530;172
ISIC_0007332;450;3;3;10.0;0.6;3024;2016;6096384;4683750;83;4683750;530766;530683;4683833;524
ISIC_0014623;200;2;3;10.0;0.6;2592;1936;5018112;1311118;843985;1311118;1937167;1093182;2155103;209
ISIC_0014623;200;1;2;100.0;0.6;2592;1936;5018112;1416049;743785;1416049;1937167;1193382;2159834;190
ISIC_0008524;50;1;3;10.0;0.6;4288;2848;12212224;6157024;12082;6157024;323767;311685;6169106;14
ISIC_0014428;300;3;2;10.0;0.6;4288;2848;12212224;1211476;1843;1211476;525860;524017;1213319;339
ISIC_0013128;50;1;1;10.0;0.6;3872;2592;10036224;6970975;0;6970975;470897;470897;6970975;4
ISIC_0008524;250;2;3;100.0;0.6;4288;2848;12212224;4539422;7441;4539422;323767;316326;4546863;270
ISIC_0008524;400;3;3;100.0;0.6;4288;2848;12212224;3931653;13085;3931653;323767;310682;3944738;465
ISIC_0008524;100;4;1;10.0;0.6;4288;2848;12212224;5000131;4773;5000131;323767;318994;5004904;109
ISIC_0007332;250;1;1;0.1;0.6;3024;2016;6096384;5122989;229;5122989;530766;530537;5123218;242
ISIC_0014623;250;2;2;0.01;0.6;2592;1936;5018112;1295691;895113;1295691;1937167;1042054;2190804;261
ISIC_0014428;150;3;3;0.1;0.6;4288;2848;12212224;1588256;2899;1588256;525860;522961;1591155;162
ISIC_0014623;300;3;1;10.0;0.6;2592;1936;5018112;1080814;1094721;1080814;1937167;842446;2175535;334
ISIC_0013082;400;4;2;100.0;0.6;3872;2592;10036224;1834505;0;1834505;254836;254836;1834505;475
ISIC_0013128;200;4;3;1.0;0.6;3872;2592;10036224;5464305;0;5464305;470897;470897;5464305;238
ISIC_0014428;50;4;2;0.01;0.6;4288;2848;12212224;3092800;3104;3092800;525860;522756;3095904;51
ISIC_0008524;100;4;2;10.0;0.6;4288;2848;12212224;5000133;4773;5000133;323767;318994;5004906;114
ISIC_0013128;400;3;1;0.1;0.6;3872;2592;10036224;4656847;0;4656847;470897;470897;4656847;452
ISIC_0012547;150;4;1;1.0;0.6;4288;2848;12212224;11558184;0;11558184;572681;572681;11558184;168
ISIC_0013128;400;3;1;10.0;0.6;3872;2592;10036224;4609405;0;4609405;470897;470897;4609405;454
ISIC_0013188;200;4;1;0.1;0.6;3008;2000;6016000;4006505;0;4006505;92544;92544;4006505;227
ISIC_0013128;350;1;2;100.0;0.6;3872;2592;10036224;5025987;0;5025987;470897;470897;5025987;370
ISIC_0013128;250;3;3;0.01;0.6;3872;2592;10036224;5400656;0;5400656;470897;470897;5400656;281
ISIC_0012547;300;3;3;1.0;0.6;4288;2848;12212224;11302652;81608;11302652;572681;491073;11384260;343
ISIC_0014623;300;4;3;10.0;0.6;2592;1936;5018112;1029987;1128003;1029987;1937167;809164;2157990;359
ISIC_0007332;150;1;3;0.1;0.6;3024;2016;6096384;5483063;0;5483063;530766;530766;5483063;132
ISIC_0014712;200;3;2;0.1;0.6;6621;4422;29278062;1503326;16788337;1503326;24292916;7504579;18291663;217
ISIC_0008524;200;4;3;0.01;0.6;4288;2848;12212224;4232089;0;4232089;323767;323767;4232089;236
ISIC_0014623;100;4;1;1.0;0.6;2592;1936;5018112;1537379;767902;1537379;1937167;1169265;2305281;108
ISIC_0012547;150;2;3;0.1;0.6;4288;2848;12212224;11548676;0;11548676;572681;572681;11548676;147
ISIC_0008524;250;4;3;100.0;0.6;4288;2848;12212224;3692084;7441;3692084;323767;316326;3699525;300
ISIC_0014712;50;4;1;0.1;0.6;6621;4422;29278062;2254141;13807762;2254141;24292916;10485154;16061903;47
ISIC_0014712;100;3;3;0.01;0.6;6621;4422;29278062;3074359;14070681;3074359;24292916;10222235;17145040;101
ISIC_0007332;100;4;1;1.0;0.6;3024;2016;6096384;0;530766;0;530766;0;530766;108
ISIC_0013128;450;2;3;0.01;0.6;3872;2592;10036224;4716050;0;4716050;470897;470897;4716050;506
ISIC_0007332;100;1;3;1.0;0.6;3024;2016;6096384;0;530766;0;530766;0;530766;73
ISIC_0012547;250;3;2;100.0;0.6;4288;2848;12212224;11494346;0;11494346;572681;572681;11494346;280
ISIC_0014712;100;2;2;100.0;0.6;6621;4422;29278062;3327018;12127946;3327018;24292916;12164970;15454964;85
ISIC_0013082;350;4;1;0.1;0.6;3872;2592;10036224;1588968;8364;1588968;254836;246472;1597332;407
ISIC_0013082;350;3;2;100.0;0.6;3872;2592;10036224;1955510;0;1955510;254836;254836;1955510;400
ISIC_0014712;450;3;2;1.0;0.6;6621;4422;29278062;1061950;18360304;1061950;24292916;5932612;19422254;518
ISIC_0013188;50;2;2;10.0;0.6;3008;2000;6016000;5062081;0;5062081;92544;92544;5062081;24
ISIC_0013188;400;1;1;0.01;0.6;3008;2000;6016000;3297750;0;3297750;92544;92544;3297750;421
ISIC_0013082;250;1;1;0.01;0.6;3872;2592;10036224;2222658;0;2222658;254836;254836;2222658;241
ISIC_0014623;350;1;1;100.0;0.6;2592;1936;5018112;1183035;940858;1183035;1937167;996309;2123893;365
ISIC_0008524;100;3;3;0.01;0.6;4288;2848;12212224;5978520;25390;5978520;323767;298377;6003910;101
ISIC_0012547;50;2;2;1.0;0.6;4288;2848;12212224;10802547;0;10802547;572681;572681;10802547;23
ISIC_0013128;50;4;2;0.01;0.6;3872;2592;10036224;7680380;0;7680380;470897;470897;7680380;51
ISIC_0008524;250;3;3;1.0;0.6;4288;2848;12212224;4330019;9729;4330019;323767;314038;4339748;283
ISIC_0014428;250;4;3;1.0;0.6;4288;2848;12212224;1362014;0;1362014;525860;525860;1362014;298
ISIC_0013128;100;3;1;10.0;0.6;3872;2592;10036224;6560444;0;6560444;470897;470897;6560444;94
ISIC_0013128;100;1;3;0.01;0.6;3872;2592;10036224;6790850;0;6790850;470897;470897;6790850;71
ISIC_0013188;450;2;2;0.1;0.6;3008;2000;6016000;3062993;0;3062993;92544;92544;3062993;502
ISIC_0003657;200;1;1;100.0;0.6;3024;2016;6096384;2099418;1525;2099418;340261;338736;2100943;185
ISIC_0003657;250;3;2;10.0;0.6;3024;2016;6096384;1772118;296;1772118;340261;339965;1772414;279
ISIC_0013128;450;2;2;0.1;0.6;3872;2592;10036224;4627765;0;4627765;470897;470897;4627765;502
ISIC_0013128;400;1;3;100.0;0.6;3872;2592;10036224;4736367;0;4736367;470897;470897;4736367;435
ISIC_0013188;50;2;2;100.0;0.6;3008;2000;6016000;5061945;0;5061945;92544;92544;5061945;25
ISIC_0014712;450;4;3;0.1;0.6;6621;4422;29278062;1010984;19405777;1010984;24292916;4887139;20416761;537
ISIC_0014712;350;1;3;0.1;0.6;6621;4422;29278062;1139774;15994576;1139774;24292916;8298340;17134350;372
ISIC_0013082;350;3;2;1.0;0.6;3872;2592;10036224;1953610;0;1953610;254836;254836;1953610;398
ISIC_0014428;300;4;3;100.0;0.6;4288;2848;12212224;1211478;1843;1211478;525860;524017;1213321;360
ISIC_0008524;400;2;1;0.01;0.6;4288;2848;12212224;3991959;1412;3991959;323767;322355;3993371;436
ISIC_0013082;100;1;3;0.1;0.6;3872;2592;10036224;3091830;4592;3091830;254836;250244;3096422;72
ISIC_0013082;150;1;1;0.01;0.6;3872;2592;10036224;3108015;0;3108015;254836;254836;3108015;121
ISIC_0013082;450;1;1;0.01;0.6;3872;2592;10036224;1749745;0;1749745;254836;254836;1749745;481
ISIC_0013128;50;3;1;1.0;0.6;3872;2592;10036224;6972734;0;6972734;470897;470897;6972734;33
ISIC_0014712;250;3;1;100.0;0.6;6621;4422;29278062;1784643;17066024;1784643;24292916;7226892;18850667;275
ISIC_0012547;450;4;2;0.1;0.6;4288;2848;12212224;11185766;116224;11185766;572681;456457;11301990;532
ISIC_0012547;100;3;1;100.0;0.6;4288;2848;12212224;0;572681;0;572681;0;572681;95
ISIC_0014428;350;4;2;0.01;0.6;4288;2848;12212224;961944;325;961944;525860;525535;962269;411
ISIC_0008524;150;2;2;100.0;0.6;4288;2848;12212224;4993804;5649;4993804;323767;318118;4999453;145
ISIC_0003657;450;1;1;100.0;0.6;3024;2016;6096384;1694939;1807;1694939;340261;338454;1696746;485
ISIC_0008524;150;2;2;0.1;0.6;4288;2848;12212224;5356407;0;5356407;323767;323767;5356407;142
ISIC_0013128;400;4;2;0.1;0.6;3872;2592;10036224;4446877;0;4446877;470897;470897;4446877;472
ISIC_0014623;50;3;3;0.1;0.6;2592;1936;5018112;2048889;442844;2048889;1937167;1494323;2491733;42
ISIC_0014428;150;1;2;0.1;0.6;4288;2848;12212224;1908923;0;1908923;525860;525860;1908923;127
ISIC_0014623;300;3;1;0.01;0.6;2592;1936;5018112;1060059;1020685;1060059;1937167;916482;2080744;331
ISIC_0014428;150;1;3;10.0;0.6;4288;2848;12212224;2154405;990;2154405;525860;524870;2155395;134
ISIC_0007332;350;4;2;1.0;0.6;3024;2016;6096384;4854667;0;4854667;530766;530766;4854667;413
ISIC_0007332;450;2;1;1.0;0.6;3024;2016;6096384;4683704;83;4683704;530766;530683;4683787;498
ISIC_0012547;450;2;3;10.0;0.6;4288;2848;12212224;11254268;54450;11254268;572681;518231;11308718;509
ISIC_0014712;300;3;3;0.1;0.6;6621;4422;29278062;1360968;17770654;1360968;24292916;6522262;19131622;342
ISIC_0003657;100;1;1;0.01;0.6;3024;2016;6096384;3114531;0;3114531;340261;340261;3114531;61
ISIC_0007332;450;2;2;0.1;0.6;3024;2016;6096384;4575313;0;4575313;530766;530766;4575313;502
ISIC_0014623;400;2;2;10.0;0.6;2592;1936;5018112;1079235;1079388;1079235;1937167;857779;2158623;444
ISIC_0008524;200;2;1;0.1;0.6;4288;2848;12212224;4896192;3087;4896192;323767;320680;4899279;197
ISIC_0008524;350;4;3;0.01;0.6;4288;2848;12212224;3431490;910;3431490;323767;322857;3432400;416
ISIC_0014712;200;2;1;0.1;0.6;6621;4422;29278062;1507708;16652749;1507708;24292916;7640167;18160457;197
ISIC_0014712;200;2;2;10.0;0.6;6621;4422;29278062;1408737;16226781;1408737;24292916;8066135;17635518;204
ISIC_0007332;200;4;3;0.1;0.6;3024;2016;6096384;5185793;0;5185793;530766;530766;5185793;237
ISIC_0007332;450;3;2;0.01;0.6;3024;2016;6096384;4624683;2469;4624683;530766;528297;4627152;516
ISIC_0003657;400;1;1;10.0;0.6;3024;2016;6096384;1781225;3890;1781225;340261;336371;1785115;424
ISIC_0014712;300;2;1;100.0;0.6;6621;4422;29278062;1318799;17086947;1318799;24292916;7205969;18405746;320
ISIC_0013188;350;2;1;10.0;0.6;3008;2000;6016000;3509667;0;3509667;92544;92544;3509667;379
ISIC_0008524;100;2;2;10.0;0.6;4288;2848;12212224;5531482;4776;5531482;323767;318991;5536258;84
ISIC_0014623;50;1;1;10.0;0.6;2592;1936;5018112;2352649;423084;2352649;1937167;1514083;2775733;4
ISIC_0013082;200;1;2;0.01;0.6;3872;2592;10036224;2385607;0;2385607;254836;254836;2385607;186
ISIC_0014428;400;2;2;100.0;0.6;4288;2848;12212224;1140318;2797;1140318;525860;523063;1143115;445
ISIC_0013128;150;3;1;100.0;0.6;3872;2592;10036224;5745345;0;5745345;470897;470897;5745345;155
ISIC_0014712;50;2;3;0.1;0.6;6621;4422;29278062;2458146;13465624;2458146;24292916;10827292;15923770;27
ISIC_0014623;250;2;1;100.0;0.6;2592;1936;5018112;1266519;966718;1266519;1937167;970449;2233237;260
ISIC_0008524;200;4;1;100.0;0.6;4288;2848;12212224;3962454;11825;3962454;323767;311942;3974279;230
ISIC_0014428;50;3;2;100.0;0.6;4288;2848;12212224;2715314;1211;2715314;525860;524649;2716525;40
ISIC_0013082;450;2;1;0.01;0.6;3872;2592;10036224;1724457;0;1724457;254836;254836;1724457;496
ISIC_0007332;250;4;1;0.01;0.6;3024;2016;6096384;5190965;0;5190965;530766;530766;5190965;286
ISIC_0008524;150;1;1;0.1;0.6;4288;2848;12212224;5347953;0;5347953;323767;323767;5347953;122
ISIC_0014712;450;3;2;0.1;0.6;6621;4422;29278062;1021441;18562676;1021441;24292916;5730240;19584117;517
ISIC_0008524;200;1;2;1.0;0.6;4288;2848;12212224;4824532;8067;4824532;323767;315700;4832599;188
ISIC_0013188;400;4;2;0.01;0.6;3008;2000;6016000;3169542;209;3169542;92544;92335;3169751;471
ISIC_0014623;400;2;2;0.1;0.6;2592;1936;5018112;1104101;1086589;1104101;1937167;850578;2190690;442
ISIC_0013082;400;4;3;100.0;0.6;3872;2592;10036224;1834505;0;1834505;254836;254836;1834505;480
ISIC_0007332;350;4;1;0.1;0.6;3024;2016;6096384;4746031;714;4746031;530766;530052;4746745;407
ISIC_0013188;50;1;1;0.1;0.6;3008;2000;6016000;5404648;0;5404648;92544;92544;5404648;2
ISIC_0014623;450;2;1;0.1;0.6;2592;1936;5018112;969040;1123620;969040;1937167;813547;2092660;497
ISIC_0008524;250;4;1;100.0;0.6;4288;2848;12212224;3692061;7441;3692061;323767;316326;3699502;290
ISIC_0014428;350;1;1;0.1;0.6;4288;2848;12212224;1246898;0;1246898;525860;525860;1246898;362
ISIC_0013188;150;3;1;0.01;0.6;3008;2000;6016000;4628332;0;4628332;92544;92544;4628332;151
ISIC_0012547;400;4;3;100.0;0.6;4288;2848;12212224;11164643;122500;11164643;572681;450181;11287143;480
ISIC_0003657;100;4;2;1.0;0.6;3024;2016;6096384;2311293;344;2311293;340261;339917;2311637;113
ISIC_0013128;50;2;3;0.1;0.6;3872;2592;10036224;7286960;0;7286960;470897;470897;7286960;27
ISIC_0014623;250;1;2;100.0;0.6;2592;1936;5018112;1407618;890836;1407618;1937167;1046331;2298454;250
ISIC_0013188;100;4;2;10.0;0.6;3008;2000;6016000;4739053;0;4739053;92544;92544;4739053;114
ISIC_0012547;250;3;3;10.0;0.6;4288;2848;12212224;11494346;0;11494346;572681;572681;11494346;284
ISIC_0012547;450;3;1;10.0;0.6;4288;2848;12212224;11227043;108900;11227043;572681;463781;11335943;514
ISIC_0013128;150;3;2;10.0;0.6;3872;2592;10036224;5745354;0;5745354;470897;470897;5745354;159
ISIC_0012547;50;4;1;1.0;0.6;4288;2848;12212224;10785681;0;10785681;572681;572681;10785681;48
ISIC_0007332;450;4;1;0.01;0.6;3024;2016;6096384;4758088;0;4758088;530766;530766;4758088;526
ISIC_0014428;150;3;3;100.0;0.6;4288;2848;12212224;1909875;990;1909875;525860;524870;1910865;165
ISIC_0012547;200;4;1;100.0;0.6;4288;2848;12212224;11252530;61009;11252530;572681;511672;11313539;230
ISIC_0003657;100;1;1;10.0;0.6;3024;2016;6096384;2754544;30;2754544;340261;340231;2754574;64
ISIC_0014428;450;2;1;0.1;0.6;4288;2848;12212224;946316;0;946316;525860;525860;946316;497
ISIC_0013188;300;4;1;0.1;0.6;3008;2000;6016000;3584011;0;3584011;92544;92544;3584011;347
ISIC_0014623;350;1;1;1.0;0.6;2592;1936;5018112;1163482;922881;1163482;1937167;1014286;2086363;363
ISIC_0008524;250;2;2;0.01;0.6;4288;2848;12212224;4780270;0;4780270;323767;323767;4780270;261
ISIC_0013128;150;3;1;0.01;0.6;3872;2592;10036224;5981704;0;5981704;470897;470897;5981704;151
ISIC_0014623;300;4;2;10.0;0.6;2592;1936;5018112;1030116;1128003;1030116;1937167;809164;2158119;354
ISIC_0003657;100;3;2;100.0;0.6;3024;2016;6096384;2439739;30;2439739;340261;340231;2439769;100
ISIC_0014712;100;4;2;1.0;0.6;6621;4422;29278062;3327049;14542075;3327049;24292916;9750841;17869124;113
ISIC_0007332;250;3;3;100.0;0.6;3024;2016;6096384;5150273;895;5150273;530766;529871;5151168;285
ISIC_0012547;50;1;1;100.0;0.6;4288;2848;12212224;10812147;0;10812147;572681;572681;10812147;5
ISIC_0003657;400;2;2;100.0;0.6;3024;2016;6096384;1609981;3890;1609981;340261;336371;1613871;445
ISIC_0013188;200;2;2;0.01;0.6;3008;2000;6016000;4203446;419;4203446;92544;92125;4203865;201
ISIC_0008524;450;1;1;0.1;0.6;4288;2848;12212224;4020896;7785;4020896;323767;315982;4028681;482
ISIC_0013082;150;1;2;1.0;0.6;3872;2592;10036224;2690840;1549;2690840;254836;253287;2692389;128
ISIC_0013082;300;2;1;10.0;0.6;3872;2592;10036224;2200751;224;2200751;254836;254612;2200975;319
ISIC_0013188;400;2;3;10.0;0.6;3008;2000;6016000;3249980;0;3249980;92544;92544;3249980;449
ISIC_0013128;250;4;2;0.01;0.6;3872;2592;10036224;5498628;0;5498628;470897;470897;5498628;291
ISIC_0014623;400;1;1;100.0;0.6;2592;1936;5018112;1185960;966885;1185960;1937167;970282;2152845;425
ISIC_0014428;100;3;2;100.0;0.6;4288;2848;12212224;2512483;534;2512483;525860;525326;2513017;100
ISIC_0007332;300;1;1;0.1;0.6;3024;2016;6096384;5006934;0;5006934;530766;530766;5006934;302
ISIC_0003657;400;2;1;1.0;0.6;3024;2016;6096384;1609993;4148;1609993;340261;336113;1614141;438
ISIC_0008524;50;2;2;10.0;0.6;4288;2848;12212224;6157018;12093;6157018;323767;311674;6169111;24
ISIC_0013188;50;3;3;10.0;0.6;3008;2000;6016000;5062081;0;5062081;92544;92544;5062081;44
ISIC_0014428;50;4;3;0.01;0.6;4288;2848;12212224;2838852;7094;2838852;525860;518766;2845946;56
ISIC_0007332;250;2;3;10.0;0.6;3024;2016;6096384;5174609;895;5174609;530766;529871;5175504;269
ISIC_0013082;50;1;1;0.01;0.6;3872;2592;10036224;3865518;0;3865518;254836;254836;3865518;1
ISIC_0014623;100;4;1;0.01;0.6;2592;1936;5018112;1756112;707686;1756112;1937167;1229481;2463798;106
ISIC_0003657;150;3;2;10.0;0.6;3024;2016;6096384;2093536;1986;2093536;340261;338275;2095522;159
ISIC_0013082;400;2;3;100.0;0.6;3872;2592;10036224;1809541;0;1809541;254836;254836;1809541;450
ISIC_0013082;300;2;3;10.0;0.6;3872;2592;10036224;2201306;224;2201306;254836;254612;2201530;329
ISIC_0014712;100;4;3;10.0;0.6;6621;4422;29278062;3327046;14542516;3327046;24292916;9750400;17869562;119
ISIC_0014428;250;4;1;10.0;0.6;4288;2848;12212224;1317627;4628;1317627;525860;521232;1322255;289
ISIC_0014712;400;1;3;0.01;0.6;6621;4422;29278062;1110425;16648108;1110425;24292916;7644808;17758533;431
ISIC_0014623;350;3;3;1.0;0.6;2592;1936;5018112;1025329;1054295;1025329;1937167;882872;2079624;403
ISIC_0013188;350;3;1;0.1;0.6;3008;2000;6016000;3371067;0;3371067;92544;92544;3371067;392
ISIC_0013188;100;1;3;10.0;0.6;3008;2000;6016000;4864404;0;4864404;92544;92544;4864404;74
ISIC_0014623;450;4;2;0.01;0.6;2592;1936;5018112;882025;1267553;882025;1937167;669614;2149578;531
ISIC_0013188;250;3;3;10.0;0.6;3008;2000;6016000;3844062;0;3844062;92544;92544;3844062;284
ISIC_0008524;50;2;1;100.0;0.6;4288;2848;12212224;6157246;12029;6157246;323767;311738;6169275;20
ISIC_0014428;400;1;2;0.1;0.6;4288;2848;12212224;999701;3301;999701;525860;522559;1003002;427
ISIC_0013128;250;4;3;1.0;0.6;3872;2592;10036224;5316489;0;5316489;470897;470897;5316489;298
ISIC_0012547;250;2;3;0.01;0.6;4288;2848;12212224;11471561;0;11471561;572681;572681;11471561;266
ISIC_0013128;250;2;2;0.01;0.6;3872;2592;10036224;5578563;0;5578563;470897;470897;5578563;261
ISIC_0014428;50;3;1;0.1;0.6;4288;2848;12212224;3039350;0;3039350;525860;525860;3039350;32
ISIC_0007332;350;1;1;1.0;0.6;3024;2016;6096384;4872718;0;4872718;530766;530766;4872718;363
ISIC_0008524;350;2;1;100.0;0.6;4288;2848;12212224;3998364;277;3998364;323767;323490;3998641;380
ISIC_0014428;100;4;1;0.1;0.6;4288;2848;12212224;1926350;14594;1926350;525860;511266;1940944;107
ISIC_0008524;50;3;2;100.0;0.6;4288;2848;12212224;6380961;12029;6380961;323767;311738;6392990;40
ISIC_0014712;450;3;3;0.01;0.6;6621;4422;29278062;927403;18307975;927403;24292916;5984941;19235378;521
ISIC_0014712;150;3;2;0.1;0.6;6621;4422;29278062;1941675;15602517;1941675;24292916;8690399;17544192;157
ISIC_0012547;250;2;2;0.01;0.6;4288;2848;12212224;11470938;0;11470938;572681;572681;11470938;261
ISIC_0013128;450;2;2;100.0;0.6;3872;2592;10036224;4668657;0;4668657;470897;470897;4668657;505
ISIC_0007332;400;3;2;0.1;0.6;3024;2016;6096384;4673568;0;4673568;530766;530766;4673568;457
ISIC_0013082;250;2;3;0.01;0.6;3872;2592;10036224;1969969;7235;1969969;254836;247601;1977204;266
ISIC_0007332;250;4;1;10.0;0.6;3024;2016;6096384;5150273;895;5150273;530766;529871;5151168;289
ISIC_0008524;50;3;2;1.0;0.6;4288;2848;12212224;6142688;14097;6142688;323767;309670;6156785;38
ISIC_0013188;450;4;1;0.01;0.6;3008;2000;6016000;3319639;0;3319639;92544;92544;3319639;526
ISIC_0012547;350;2;2;0.01;0.6;4288;2848;12212224;11357026;0;11357026;572681;572681;11357026;381
ISIC_0013128;300;1;3;100.0;0.6;3872;2592;10036224;5178619;39;5178619;470897;470858;5178658;315
ISIC_0014712;100;4;3;100.0;0.6;6621;4422;29278062;3327046;14542516;3327046;24292916;9750400;17869562;120
ISIC_0008524;250;2;3;10.0;0.6;4288;2848;12212224;4539187;7441;4539187;323767;316326;4546628;269
ISIC_0013128;450;2;1;1.0;0.6;3872;2592;10036224;4668783;0;4668783;470897;470897;4668783;498
ISIC_0003657;350;3;1;100.0;0.6;3024;2016;6096384;1613850;2927;1613850;340261;337334;1616777;395
ISIC_0013128;300;4;3;0.01;0.6;3872;2592;10036224;5028429;0;5028429;470897;470897;5028429;356
ISIC_0003657;400;3;3;0.1;0.6;3024;2016;6096384;1577996;0;1577996;340261;340261;1577996;462
ISIC_0012547;350;3;2;100.0;0.6;4288;2848;12212224;11254071;71369;11254071;572681;501312;11325440;400
ISIC_0013082;350;1;2;1.0;0.6;3872;2592;10036224;1953679;0;1953679;254836;254836;1953679;368
ISIC_0013128;250;3;1;1.0;0.6;3872;2592;10036224;5441437;0;5441437;470897;470897;5441437;273
ISIC_0013128;200;3;1;100.0;0.6;3872;2592;10036224;5570725;0;5570725;470897;470897;5570725;215
ISIC_0014712;350;2;2;100.0;0.6;6621;4422;29278062;1252247;17087981;1252247;24292916;7204935;18340228;385
ISIC_0014712;400;3;3;1.0;0.6;6621;4422;29278062;1239185;17659290;1239185;24292916;6633626;18898475;463
ISIC_0013188;200;1;3;1.0;0.6;3008;2000;6016000;4062416;0;4062416;92544;92544;4062416;193
ISIC_0013128;250;4;3;100.0;0.6;3872;2592;10036224;5316829;0;5316829;470897;470897;5316829;300
ISIC_0013082;350;2;1;10.0;0.6;3872;2592;10036224;1955526;0;1955526;254836;254836;1955526;379
ISIC_0013128;200;4;3;100.0;0.6;3872;2592;10036224;5464774;0;5464774;470897;470897;5464774;240
ISIC_0014428;450;4;1;1.0;0.6;4288;2848;12212224;1121961;2747;1121961;525860;523113;1124708;528
ISIC_0014428;250;4;2;1.0;0.6;4288;2848;12212224;1361821;0;1361821;525860;525860;1361821;293
ISIC_0003657;150;3;1;1.0;0.6;3024;2016;6096384;2052614;2148;2052614;340261;338113;2054762;153
ISIC_0014428;400;3;2;0.1;0.6;4288;2848;12212224;897262;3293;897262;525860;522567;900555;457
ISIC_0014428;450;1;3;100.0;0.6;4288;2848;12212224;1237543;8163;1237543;525860;517697;1245706;495
ISIC_0003657;200;1;2;100.0;0.6;3024;2016;6096384;2128298;304;2128298;340261;339957;2128602;190
ISIC_0003657;150;3;2;1.0;0.6;3024;2016;6096384;2052598;2139;2052598;340261;338122;2054737;158
ISIC_0013128;400;4;1;100.0;0.6;3872;2592;10036224;4483555;0;4483555;470897;470897;4483555;470
ISIC_0014428;250;2;2;10.0;0.6;4288;2848;12212224;1366468;4628;1366468;525860;521232;1371096;264
ISIC_0014623;250;1;1;0.1;0.6;2592;1936;5018112;1385375;943748;1385375;1937167;993419;2329123;242
ISIC_0014623;50;1;1;0.1;0.6;2592;1936;5018112;2416746;427321;2416746;1937167;1509846;2844067;2
ISIC_0014623;300;1;2;0.1;0.6;2592;1936;5018112;1218539;967650;1218539;1937167;969517;2186189;307
ISIC_0014712;300;2;2;1.0;0.6;6621;4422;29278062;1318803;17086599;1318803;24292916;7206317;18405402;323
ISIC_0014428;100;2;2;0.01;0.6;4288;2848;12212224;2786124;0;2786124;525860;525860;2786124;81
ISIC_0013082;100;3;2;0.1;0.6;3872;2592;10036224;2998672;10830;2998672;254836;244006;3009502;97
ISIC_0003657;400;4;1;0.01;0.6;3024;2016;6096384;1501838;90;1501838;340261;340171;1501928;466
ISIC_0014428;200;4;1;0.01;0.6;4288;2848;12212224;1548736;0;1548736;525860;525860;1548736;226
ISIC_0013082;400;4;1;10.0;0.6;3872;2592;10036224;1834346;0;1834346;254836;254836;1834346;469
ISIC_0014712;300;4;2;1.0;0.6;6621;4422;29278062;1314379;18364695;1314379;24292916;5928221;19679074;353
ISIC_0012547;400;2;2;1.0;0.6;4288;2848;12212224;11219719;0;11219719;572681;572681;11219719;443
ISIC_0014428;400;3;2;10.0;0.6;4288;2848;12212224;1108993;2797;1108993;525860;523063;1111790;459
ISIC_0008524;200;2;2;10.0;0.6;4288;2848;12212224;4659214;11825;4659214;323767;311942;4671039;204
ISIC_0013128;150;3;2;0.01;0.6;3872;2592;10036224;6065210;0;6065210;470897;470897;6065210;156
ISIC_0007332;100;2;3;10.0;0.6;3024;2016;6096384;0;530766;0;530766;0;530766;89
ISIC_0013082;250;3;3;100.0;0.6;3872;2592;10036224;2106430;0;2106430;254836;254836;2106430;285
ISIC_0013188;150;4;1;0.1;0.6;3008;2000;6016000;4351253;0;4351253;92544;92544;4351253;167
ISIC_0014428;50;4;1;0.01;0.6;4288;2848;12212224;3362546;0;3362546;525860;525860;3362546;46
ISIC_0012547;350;1;3;0.01;0.6;4288;2848;12212224;11442339;399;11442339;572681;572282;11442738;371
ISIC_0014623;200;1;3;10.0;0.6;2592;1936;5018112;1415860;743874;1415860;1937167;1193293;2159734;194
ISIC_0007332;350;3;2;0.01;0.6;3024;2016;6096384;4694358;0;4694358;530766;530766;4694358;396
ISIC_0014712;350;4;1;1.0;0.6;6621;4422;29278062;1244921;18095243;1244921;24292916;6197673;19340164;408
ISIC_0014623;200;1;3;0.01;0.6;2592;1936;5018112;1501267;855551;1501267;1937167;1081616;2356818;191
ISIC_0012547;250;4;2;10.0;0.6;4288;2848;12212224;11494346;0;11494346;572681;572681;11494346;294
ISIC_0013128;300;2;1;10.0;0.6;3872;2592;10036224;5142267;39;5142267;470897;470858;5142306;319
ISIC_0013128;400;1;2;100.0;0.6;3872;2592;10036224;4736368;0;4736368;470897;470897;4736368;430
ISIC_0013128;150;3;1;10.0;0.6;3872;2592;10036224;5745345;0;5745345;470897;470897;5745345;154
ISIC_0013128;350;1;2;1.0;0.6;3872;2592;10036224;5025754;0;5025754;470897;470897;5025754;368
ISIC_0008524;450;1;2;10.0;0.6;4288;2848;12212224;4007581;18436;4007581;323767;305331;4026017;489
ISIC_0014712;200;4;2;0.01;0.6;6621;4422;29278062;1486657;17365914;1486657;24292916;6927002;18852571;231
ISIC_0013188;200;2;1;100.0;0.6;3008;2000;6016000;4007583;0;4007583;92544;92544;4007583;200
ISIC_0014428;150;4;1;10.0;0.6;4288;2848;12212224;1828088;990;1828088;525860;524870;1829078;169
ISIC_0013082;200;2;1;10.0;0.6;3872;2592;10036224;2123893;200;2123893;254836;254636;2124093;199
ISIC_0014623;400;2;3;1.0;0.6;2592;1936;5018112;1079539;1079249;1079539;1937167;857918;2158788;448
ISIC_0007332;50;4;2;100.0;0.6;3024;2016;6096384;5150085;0;5150085;530766;530766;5150085;55
ISIC_0012547;50;3;1;0.1;0.6;4288;2848;12212224;0;572681;0;572681;0;572681;32
ISIC_0013188;450;1;3;1.0;0.6;3008;2000;6016000;3165535;665;3165535;92544;91879;3166200;493
ISIC_0013188;200;1;3;0.1;0.6;3008;2000;6016000;4047508;0;4047508;92544;92544;4047508;192
ISIC_0014428;100;4;2;0.01;0.6;4288;2848;12212224;2502303;0;2502303;525860;525860;2502303;111
ISIC_0014623;450;1;3;1.0;0.6;2592;1936;5018112;1098553;1022450;1098553;1937167;914717;2121003;493
ISIC_0014623;150;2;1;0.01;0.6;2592;1936;5018112;1599904;686897;1599904;1937167;1250270;2286801;136
ISIC_0013188;450;1;2;0.1;0.6;3008;2000;6016000;3067656;0;3067656;92544;92544;3067656;487
ISIC_0014623;100;2;1;10.0;0.6;2592;1936;5018112;1621541;624354;1621541;1937167;1312813;2245895;79
ISIC_0014623;450;3;3;1.0;0.6;2592;1936;5018112;954557;1178570;954557;1937167;758597;2133127;523
ISIC_0014712;350;1;2;0.01;0.6;6621;4422;29278062;1137677;15874352;1137677;24292916;8418564;17012029;366
ISIC_0007332;150;3;3;0.01;0.6;3024;2016;6096384;5433115;0;5433115;530766;530766;5433115;161
ISIC_0008524;50;2;1;0.01;0.6;4288;2848;12212224;7687733;0;7687733;323767;323767;7687733;16
ISIC_0013082;50;3;2;100.0;0.6;3872;2592;10036224;3808603;0;3808603;254836;254836;3808603;40
ISIC_0012547;300;3;2;0.01;0.6;4288;2848;12212224;11422015;64172;11422015;572681;508509;11486187;336
ISIC_0003657;150;1;1;1.0;0.6;3024;2016;6096384;2417684;2415;2417684;340261;337846;2420099;123
ISIC_0013188;450;4;3;100.0;0.6;3008;2000;6016000;3126270;0;3126270;92544;92544;3126270;540
ISIC_0008524;450;2;1;1.0;0.6;4288;2848;12212224;3892202;14329;3892202;323767;309438;3906531;498
ISIC_0013188;450;2;2;100.0;0.6;3008;2000;6016000;3126247;0;3126247;92544;92544;3126247;505
ISIC_0008524;300;4;1;100.0;0.6;4288;2848;12212224;3661635;4070;3661635;323767;319697;3665705;350
ISIC_0007332;350;2;2;0.1;0.6;3024;2016;6096384;4760698;77;4760698;530766;530689;4760775;382
ISIC_0012547;250;2;1;1.0;0.6;4288;2848;12212224;11493832;0;11493832;572681;572681;11493832;258
ISIC_0013082;350;4;3;0.1;0.6;3872;2592;10036224;1615257;7985;1615257;254836;246851;1623242;417
ISIC_0014623;400;4;3;1.0;0.6;2592;1936;5018112;976767;1142970;976767;1937167;794197;2119737;478
ISIC_0014712;250;1;2;10.0;0.6;6621;4422;29278062;2006507;15387170;2006507;24292916;8905746;17393677;249
ISIC_0012547;200;3;3;100.0;0.6;4288;2848;12212224;11253140;0;11253140;572681;572681;11253140;225
ISIC_0014623;300;2;1;0.1;0.6;2592;1936;5018112;1101696;1031081;1101696;1937167;906086;2132777;317
ISIC_0013188;250;1;1;0.01;0.6;3008;2000;6016000;4084432;0;4084432;92544;92544;4084432;241
ISIC_0014428;250;1;2;0.01;0.6;4288;2848;12212224;1324548;0;1324548;525860;525860;1324548;246
ISIC_0008524;100;3;2;0.01;0.6;4288;2848;12212224;6094897;2705;6094897;323767;321062;6097602;96
ISIC_0013128;400;2;2;1.0;0.6;3872;2592;10036224;4632606;0;4632606;470897;470897;4632606;443
ISIC_0013082;250;1;1;10.0;0.6;3872;2592;10036224;2106229;0;2106229;254836;254836;2106229;244
ISIC_0012547;400;4;3;1.0;0.6;4288;2848;12212224;11135646;122500;11135646;572681;450181;11258146;478
ISIC_0007332;150;3;2;100.0;0.6;3024;2016;6096384;5525218;0;5525218;530766;530766;5525218;160
ISIC_0014623;50;1;2;0.01;0.6;2592;1936;5018112;2423630;260710;2423630;1937167;1676457;2684340;6
ISIC_0007332;150;1;1;1.0;0.6;3024;2016;6096384;5525218;0;5525218;530766;530766;5525218;123
ISIC_0013082;150;4;3;0.1;0.6;3872;2592;10036224;2849648;346;2849648;254836;254490;2849994;177
ISIC_0014623;150;4;3;1.0;0.6;2592;1936;5018112;1308205;917828;1308205;1937167;1019339;2226033;178
ISIC_0014712;300;4;3;10.0;0.6;6621;4422;29278062;1314378;18364846;1314378;24292916;5928070;19679224;359
ISIC_0013128;400;4;2;100.0;0.6;3872;2592;10036224;4483558;0;4483558;470897;470897;4483558;475
ISIC_0013128;300;2;1;0.1;0.6;3872;2592;10036224;5104221;0;5104221;470897;470897;5104221;317
ISIC_0003657;250;4;1;100.0;0.6;3024;2016;6096384;1668814;296;1668814;340261;339965;1669110;290
ISIC_0013188;400;3;1;1.0;0.6;3008;2000;6016000;3234441;0;3234441;92544;92544;3234441;453
ISIC_0008524;250;2;3;0.01;0.6;4288;2848;12212224;4641573;11921;4641573;323767;311846;4653494;266
ISIC_0007332;250;4;3;10.0;0.6;3024;2016;6096384;5150273;895;5150273;530766;529871;5151168;299
ISIC_0007332;300;4;3;0.1;0.6;3024;2016;6096384;5000326;0;5000326;530766;530766;5000326;357
ISIC_0007332;50;2;2;0.01;0.6;3024;2016;6096384;0;530766;0;530766;0;530766;21
ISIC_0014712;300;3;1;10.0;0.6;6621;4422;29278062;1314374;17478140;1314374;24292916;6814776;18792514;334
ISIC_0014623;350;2;2;0.1;0.6;2592;1936;5018112;1069304;1037077;1069304;1937167;900090;2106381;382
ISIC_0014623;300;1;2;10.0;0.6;2592;1936;5018112;1226230;956160;1226230;1937167;981007;2182390;309
ISIC_0007332;50;1;2;0.01;0.6;3024;2016;6096384;0;530766;0;530766;0;530766;6
ISIC_0003657;50;4;1;0.1;0.6;3024;2016;6096384;2722044;5335;2722044;340261;334926;2727379;47
ISIC_0007332;300;4;3;10.0;0.6;3024;2016;6096384;5088423;0;5088423;530766;530766;5088423;359
ISIC_0012547;200;4;1;0.01;0.6;4288;2848;12212224;11558205;0;11558205;572681;572681;11558205;226
ISIC_0003657;50;2;3;1.0;0.6;3024;2016;6096384;2634045;53;2634045;340261;340208;2634098;28
ISIC_0012547;400;3;1;100.0;0.6;4288;2848;12212224;11191891;61250;11191891;572681;511431;11253141;455
ISIC_0013128;450;3;2;10.0;0.6;3872;2592;10036224;4620860;0;4620860;470897;470897;4620860;519
ISIC_0003657;300;4;3;10.0;0.6;3024;2016;6096384;1540350;2883;1540350;340261;337378;1543233;359
ISIC_0007332;350;1;1;0.01;0.6;3024;2016;6096384;4907892;0;4907892;530766;530766;4907892;361
ISIC_0013128;350;2;1;1.0;0.6;3872;2592;10036224;4996965;0;4996965;470897;470897;4996965;378
ISIC_0008524;450;3;2;0.1;0.6;4288;2848;12212224;3721589;10660;3721589;323767;313107;3732249;517
ISIC_0003657;100;2;3;0.01;0.6;3024;2016;6096384;2538636;16379;2538636;340261;323882;2555015;86
ISIC_0013188;450;1;1;100.0;0.6;3008;2000;6016000;3139687;0;3139687;92544;92544;3139687;485
ISIC_0013128;450;3;2;0.01;0.6;3872;2592;10036224;4674474;0;4674474;470897;470897;4674474;516
ISIC_0008524;50;3;2;0.01;0.6;4288;2848;12212224;7240067;21966;7240067;323767;301801;7262033;36
ISIC_0003657;250;3;1;1.0;0.6;3024;2016;6096384;1745754;307;1745754;340261;339954;1746061;273
ISIC_0003657;450;1;3;100.0;0.6;3024;2016;6096384;1694939;1807;1694939;340261;338454;1696746;495
ISIC_0012547;300;4;2;0.01;0.6;4288;2848;12212224;11433658;0;11433658;572681;572681;11433658;351
ISIC_0007332;350;3;3;0.1;0.6;3024;2016;6096384;4772374;643;4772374;530766;530123;4773017;402
ISIC_0013128;350;3;1;100.0;0.6;3872;2592;10036224;4845101;0;4845101;470897;470897;4845101;395
ISIC_0014623;200;2;2;1.0;0.6;2592;1936;5018112;1311178;843839;1311178;1937167;1093328;2155017;203
ISIC_0012547;200;1;2;1.0;0.6;4288;2848;12212224;11263959;0;11263959;572681;572681;11263959;188
ISIC_0014623;250;4;1;0.1;0.6;2592;1936;5018112;1105909;1065791;1105909;1937167;871376;2171700;287
ISIC_0008524;300;2;1;100.0;0.6;4288;2848;12212224;4395364;4070;4395364;323767;319697;4399434;320
ISIC_0014712;350;4;1;100.0;0.6;6621;4422;29278062;1244918;18095605;1244918;24292916;6197311;19340523;410
ISIC_0003657;300;2;2;10.0;0.6;3024;2016;6096384;1706581;2337;1706581;340261;337924;1708918;324
ISIC_0013188;400;3;2;100.0;0.6;3008;2000;6016000;3250048;0;3250048;92544;92544;3250048;460
ISIC_0013128;50;2;1;0.01;0.6;3872;2592;10036224;7888742;0;7888742;470897;470897;7888742;16
ISIC_0014428;200;3;2;100.0;0.6;4288;2848;12212224;1500209;999;1500209;525860;524861;1501208;220
ISIC_0008524;300;2;1;0.1;0.6;4288;2848;12212224;4366891;10201;4366891;323767;313566;4377092;317
ISIC_0013082;150;2;3;100.0;0.6;3872;2592;10036224;2759697;183;2759697;254836;254653;2759880;150
ISIC_0013082;350;4;2;1.0;0.6;3872;2592;10036224;1953339;0;1953339;254836;254836;1953339;413
ISIC_0014623;200;2;3;1.0;0.6;2592;1936;5018112;1311215;843943;1311215;1937167;1093224;2155158;208
ISIC_0007332;50;4;1;1.0;0.6;3024;2016;6096384;5116917;0;5116917;530766;530766;5116917;48
ISIC_0014428;250;4;3;10.0;0.6;4288;2848;12212224;1317627;4628;1317627;525860;521232;1322255;299
ISIC_0013082;50;1;3;0.01;0.6;3872;2592;10036224;3451095;6601;3451095;254836;248235;3457696;11
ISIC_0014623;350;3;3;0.1;0.6;2592;1936;5018112;976877;1067319;976877;1937167;869848;2044196;402
ISIC_0007332;400;3;1;10.0;0.6;3024;2016;6096384;4811876;0;4811876;530766;530766;4811876;454
ISIC_0012547;150;1;2;0.1;0.6;4288;2848;12212224;11460287;0;11460287;572681;572681;11460287;127
ISIC_0013128;200;3;2;10.0;0.6;3872;2592;10036224;5615094;0;5615094;470897;470897;5615094;219
ISIC_0003657;250;4;3;10.0;0.6;3024;2016;6096384;1642692;296;1642692;340261;339965;1642988;299
ISIC_0013128;100;1;1;10.0;0.6;3872;2592;10036224;6977526;0;6977526;470897;470897;6977526;64
ISIC_0008524;200;2;2;100.0;0.6;4288;2848;12212224;4659214;11825;4659214;323767;311942;4671039;205
ISIC_0007332;350;1;1;10.0;0.6;3024;2016;6096384;4871959;0;4871959;530766;530766;4871959;364
ISIC_0012547;150;1;1;0.1;0.6;4288;2848;12212224;11459492;0;11459492;572681;572681;11459492;122
ISIC_0014623;300;2;3;100.0;0.6;2592;1936;5018112;1113968;1061439;1113968;1937167;875728;2175407;330
ISIC_0014712;150;1;3;100.0;0.6;6621;4422;29278062;2009579;13809811;2009579;24292916;10483105;15819390;135
ISIC_0003657;300;4;1;10.0;0.6;3024;2016;6096384;1540436;2883;1540436;340261;337378;1543319;349
ISIC_0007332;450;4;1;100.0;0.6;3024;2016;6096384;4640935;83;4640935;530766;530683;4641018;530
ISIC_0012547;300;4;1;100.0;0.6;4288;2848;12212224;11305031;163216;11305031;572681;409465;11468247;350
ISIC_0014623;450;3;1;0.1;0.6;2592;1936;5018112;939000;1178728;939000;1937167;758439;2117728;512
ISIC_0013188;50;3;1;0.1;0.6;3008;2000;6016000;5403609;0;5403609;92544;92544;5403609;32
ISIC_0014712;450;3;1;0.1;0.6;6621;4422;29278062;963139;18500846;963139;24292916;5792070;19463985;512
ISIC_0014712;350;4;3;10.0;0.6;6621;4422;29278062;1245619;18095213;1245619;24292916;6197703;19340832;419
ISIC_0003657;50;4;2;0.1;0.6;3024;2016;6096384;2843125;501;2843125;340261;339760;2843626;52
ISIC_0013082;400;1;1;100.0;0.6;3872;2592;10036224;1809540;0;1809540;254836;254836;1809540;425
ISIC_0014623;450;1;2;100.0;0.6;2592;1936;5018112;1111342;1023020;1111342;1937167;914147;2134362;490
ISIC_0014428;50;1;1;0.1;0.6;4288;2848;12212224;3189943;0;3189943;525860;525860;3189943;2
ISIC_0014428;450;1;1;1.0;0.6;4288;2848;12212224;1257296;1272;1257296;525860;524588;1258568;483
ISIC_0008524;250;1;1;0.1;0.6;4288;2848;12212224;4603474;4516;4603474;323767;319251;4607990;242
ISIC_0008524;400;4;2;0.1;0.6;4288;2848;12212224;3138526;3631;3138526;323767;320136;3142157;472
ISIC_0012547;250;3;3;0.01;0.6;4288;2848;12212224;11563402;0;11563402;572681;572681;11563402;281
ISIC_0013082;350;4;2;0.01;0.6;3872;2592;10036224;1703333;0;1703333;254836;254836;1703333;411
ISIC_0007332;150;4;1;0.01;0.6;3024;2016;6096384;5475736;0;5475736;530766;530766;5475736;166
ISIC_0014712;400;3;1;1.0;0.6;6621;4422;29278062;1239192;17659627;1239192;24292916;6633289;18898819;453
ISIC_0007332;200;2;1;100.0;0.6;3024;2016;6096384;5168995;0;5168995;530766;530766;5168995;200
ISIC_0008524;200;3;3;10.0;0.6;4288;2848;12212224;4547314;11825;4547314;323767;311942;4559139;224
ISIC_0013128;450;1;3;0.1;0.6;3872;2592;10036224;4679217;0;4679217;470897;470897;4679217;492
ISIC_0013188;450;2;3;0.01;0.6;3008;2000;6016000;3194641;0;3194641;92544;92544;3194641;506
ISIC_0012547;150;4;2;0.1;0.6;4288;2848;12212224;11555709;0;11555709;572681;572681;11555709;172
ISIC_0008524;350;2;3;100.0;0.6;4288;2848;12212224;3998569;277;3998569;323767;323490;3998846;390
ISIC_0014623;50;4;3;0.1;0.6;2592;1936;5018112;2048725;441939;2048725;1937167;1495228;2490664;57
ISIC_0003657;350;3;3;1.0;0.6;3024;2016;6096384;1614285;2927;1614285;340261;337334;1617212;403
ISIC_0013188;200;3;1;1.0;0.6;3008;2000;6016000;4059112;0;4059112;92544;92544;4059112;213
ISIC_0007332;100;1;1;0.01;0.6;3024;2016;6096384;0;530766;0;530766;0;530766;61
ISIC_0014623;400;4;1;0.1;0.6;2592;1936;5018112;955760;1176750;955760;1937167;760417;2132510;467
ISIC_0014623;50;1;3;0.1;0.6;2592;1936;5018112;2416822;428272;2416822;1937167;1508895;2845094;12
ISIC_0013128;200;2;1;10.0;0.6;3872;2592;10036224;5661375;0;5661375;470897;470897;5661375;199
ISIC_0008524;50;4;1;1.0;0.6;4288;2848;12212224;5478283;13661;5478283;323767;310106;5491944;48
ISIC_0013188;450;4;1;100.0;0.6;3008;2000;6016000;3126240;0;3126240;92544;92544;3126240;530
ISIC_0012547;50;2;2;10.0;0.6;4288;2848;12212224;10812014;0;10812014;572681;572681;10812014;24
ISIC_0012547;250;3;2;10.0;0.6;4288;2848;12212224;11494346;0;11494346;572681;572681;11494346;279
ISIC_0003657;300;4;2;1.0;0.6;3024;2016;6096384;1540042;3130;1540042;340261;337131;1543172;353
ISIC_0007332;400;3;1;1.0;0.6;3024;2016;6096384;4795899;0;4795899;530766;530766;4795899;453
ISIC_0003657;200;1;3;1.0;0.6;3024;2016;6096384;2128532;391;2128532;340261;339870;2128923;193
ISIC_0007332;50;1;3;10.0;0.6;3024;2016;6096384;5150051;0;5150051;530766;530766;5150051;14
ISIC_0012547;450;2;2;0.1;0.6;4288;2848;12212224;11205161;57721;11205161;572681;514960;11262882;502
ISIC_0013128;250;1;2;0.01;0.6;3872;2592;10036224;5463728;0;5463728;470897;470897;5463728;246
ISIC_0008524;150;4;1;10.0;0.6;4288;2848;12212224;4172718;5649;4172718;323767;318118;4178367;169
ISIC_0012547;100;4;1;1.0;0.6;4288;2848;12212224;0;572681;0;572681;0;572681;108
ISIC_0013128;250;3;2;10.0;0.6;3872;2592;10036224;5441794;0;5441794;470897;470897;5441794;279
ISIC_0013128;300;1;2;100.0;0.6;3872;2592;10036224;5178431;39;5178431;470897;470858;5178470;310
ISIC_0013128;100;2;1;1.0;0.6;3872;2592;10036224;6775208;0;6775208;470897;470897;6775208;78
ISIC_0013128;200;4;1;1.0;0.6;3872;2592;10036224;5464261;0;5464261;470897;470897;5464261;228
ISIC_0014623;100;2;1;0.01;0.6;2592;1936;5018112;1749274;617771;1749274;1937167;1319396;2367045;76
ISIC_0014623;100;4;3;0.01;0.6;2592;1936;5018112;1683806;721990;1683806;1937167;1215177;2405796;116
ISIC_0014712;350;4;1;0.1;0.6;6621;4422;29278062;1124419;18288805;1124419;24292916;6004111;19413224;407
ISIC_0007332;250;4;2;1.0;0.6;3024;2016;6096384;5150637;895;5150637;530766;529871;5151532;293
ISIC_0003657;450;3;2;100.0;0.6;3024;2016;6096384;1411827;1807;1411827;340261;338454;1413634;520
ISIC_0013082;200;2;1;0.01;0.6;3872;2592;10036224;2494166;974;2494166;254836;253862;2495140;196
ISIC_0012547;100;4;3;100.0;0.6;4288;2848;12212224;0;572681;0;572681;0;572681;120
ISIC_0014712;150;3;1;1.0;0.6;6621;4422;29278062;1999260;15360638;1999260;24292916;8932278;17359898;153
ISIC_0003657;150;2;2;100.0;0.6;3024;2016;6096384;2215834;1986;2215834;340261;338275;2217820;145
ISIC_0007332;50;4;1;0.01;0.6;3024;2016;6096384;0;530766;0;530766;0;530766;46
ISIC_0003657;300;2;2;1.0;0.6;3024;2016;6096384;1707225;2511;1707225;340261;337750;1709736;323
ISIC_0013082;250;3;1;0.01;0.6;3872;2592;10036224;2209955;0;2209955;254836;254836;2209955;271
ISIC_0013082;400;2;3;0.01;0.6;3872;2592;10036224;1375631;12804;1375631;254836;242032;1388435;446
ISIC_0013082;450;2;1;1.0;0.6;3872;2592;10036224;1743029;3472;1743029;254836;251364;1746501;498
ISIC_0013188;400;2;1;100.0;0.6;3008;2000;6016000;3250017;0;3250017;92544;92544;3250017;440
ISIC_0007332;450;3;2;0.1;0.6;3024;2016;6096384;4590631;377;4590631;530766;530389;4591008;517
ISIC_0014623;250;2;3;1.0;0.6;2592;1936;5018112;1266600;966447;1266600;1937167;970720;2233047;268
ISIC_0014428;50;3;2;10.0;0.6;4288;2848;12212224;2715588;1211;2715588;525860;524649;2716799;39
ISIC_0003657;100;4;3;0.01;0.6;3024;2016;6096384;2128124;24297;2128124;340261;315964;2152421;116
ISIC_0013128;200;1;3;0.01;0.6;3872;2592;10036224;5833000;0;5833000;470897;470897;5833000;191
ISIC_0008524;100;4;3;100.0;0.6;4288;2848;12212224;5000589;4772;5000589;323767;318995;5005361;120
ISIC_0012547;400;3;1;10.0;0.6;4288;2848;12212224;11191891;61250;11191891;572681;511431;11253141;454
ISIC_0013188;450;3;2;10.0;0.6;3008;2000;6016000;3126129;0;3126129;92544;92544;3126129;519
ISIC_0003657;350;1;1;0.01;0.6;3024;2016;6096384;2029743;0;2029743;340261;340261;2029743;361
ISIC_0013188;300;1;1;1.0;0.6;3008;2000;6016000;3675166;30;3675166;92544;92514;3675196;303
ISIC_0008524;350;4;1;10.0;0.6;4288;2848;12212224;3333250;277;3333250;323767;323490;3333527;409
ISIC_0014428;300;2;2;0.01;0.6;4288;2848;12212224;1335019;630;1335019;525860;525230;1335649;321
ISIC_0014623;450;3;1;1.0;0.6;2592;1936;5018112;954552;1178534;954552;1937167;758633;2133086;513
ISIC_0007332;150;4;3;0.01;0.6;3024;2016;6096384;5435186;0;5435186;530766;530766;5435186;176
ISIC_0014428;350;3;3;10.0;0.6;4288;2848;12212224;1232873;6259;1232873;525860;519601;1239132;404
ISIC_0014428;200;2;1;0.1;0.6;4288;2848;12212224;1652815;0;1652815;525860;525860;1652815;197
ISIC_0013188;350;4;1;10.0;0.6;3008;2000;6016000;3509667;0;3509667;92544;92544;3509667;409
ISIC_0012547;350;4;3;10.0;0.6;4288;2848;12212224;11254071;106338;11254071;572681;466343;11360409;419
ISIC_0014428;300;4;2;1.0;0.6;4288;2848;12212224;1124731;2246;1124731;525860;523614;1126977;353
ISIC_0008524;250;1;2;100.0;0.6;4288;2848;12212224;4539446;7441;4539446;323767;316326;4546887;250
ISIC_0012547;400;4;2;100.0;0.6;4288;2848;12212224;11164643;122500;11164643;572681;450181;11287143;475
ISIC_0012547;400;1;3;0.01;0.6;4288;2848;12212224;11410576;0;11410576;572681;572681;11410576;431
ISIC_0014712;450;4;2;100.0;0.6;6621;4422;29278062;1058239;19009863;1058239;24292916;5283053;20068102;535
ISIC_0014712;400;4;2;1.0;0.6;6621;4422;29278062;1232270;18910800;1232270;24292916;5382116;20143070;473
ISIC_0014623;400;3;1;0.01;0.6;2592;1936;5018112;1006678;1116945;1006678;1937167;820222;2123623;451
ISIC_0003657;150;1;1;0.1;0.6;3024;2016;6096384;2451920;0;2451920;340261;340261;2451920;122
ISIC_0003657;200;3;3;0.1;0.6;3024;2016;6096384;1973621;0;1973621;340261;340261;1973621;222
ISIC_0012547;450;4;3;1.0;0.6;4288;2848;12212224;11089295;108868;11089295;572681;463813;11198163;538
ISIC_0013082;400;3;3;100.0;0.6;3872;2592;10036224;1834505;0;1834505;254836;254836;1834505;465
ISIC_0013082;450;1;3;100.0;0.6;3872;2592;10036224;1722804;1608;1722804;254836;253228;1724412;495
ISIC_0003657;50;2;2;0.1;0.6;3024;2016;6096384;3411628;433;3411628;340261;339828;3412061;22
ISIC_0013128;400;2;2;0.1;0.6;3872;2592;10036224;4677712;0;4677712;470897;470897;4677712;442
ISIC_0013082;50;3;1;100.0;0.6;3872;2592;10036224;3808773;0;3808773;254836;254836;3808773;35
ISIC_0003657;150;1;2;100.0;0.6;3024;2016;6096384;2377437;1986;2377437;340261;338275;2379423;130
ISIC_0007332;150;4;2;10.0;0.6;3024;2016;6096384;5525218;0;5525218;530766;530766;5525218;174
ISIC_0013188;50;4;2;1.0;0.6;3008;2000;6016000;4947196;0;4947196;92544;92544;4947196;53
ISIC_0012547;200;3;1;1.0;0.6;4288;2848;12212224;11263994;0;11263994;572681;572681;11263994;213
ISIC_0007332;200;4;1;1.0;0.6;3024;2016;6096384;5168968;0;5168968;530766;530766;5168968;228
ISIC_0013082;350;2;2;0.1;0.6;3872;2592;10036224;1631815;0;1631815;254836;254836;1631815;382
ISIC_0003657;300;2;3;100.0;0.6;3024;2016;6096384;1706619;2337;1706619;340261;337924;1708956;330
ISIC_0013188;400;3;1;0.1;0.6;3008;2000;6016000;3130057;0;3130057;92544;92544;3130057;452
ISIC_0014428;100;2;2;1.0;0.6;4288;2848;12212224;2508773;8636;2508773;525860;517224;2517409;83
ISIC_0014712;450;2;1;100.0;0.6;6621;4422;29278062;1061987;18096632;1061987;24292916;6196284;19158619;500
ISIC_0012547;250;1;1;10.0;0.6;4288;2848;12212224;11494346;0;11494346;572681;572681;11494346;244
ISIC_0014428;300;2;2;1.0;0.6;4288;2848;12212224;1165810;2306;1165810;525860;523554;1168116;323
ISIC_0012547;200;4;2;10.0;0.6;4288;2848;12212224;11252507;61009;11252507;572681;511672;11313516;234
ISIC_0014623;150;2;2;0.1;0.6;2592;1936;5018112;1579286;731131;1579286;1937167;1206036;2310417;142
ISIC_0014712;100;2;1;10.0;0.6;6621;4422;29278062;3327017;12128286;3327017;24292916;12164630;15455303;79
ISIC_0013188;300;1;3;1.0;0.6;3008;2000;6016000;3695437;42;3695437;92544;92502;3695479;313
ISIC_0013082;100;1;3;100.0;0.6;3872;2592;10036224;3103817;0;3103817;254836;254836;3103817;75
ISIC_0014712;100;4;1;0.01;0.6;6621;4422;29278062;3076556;15340839;3076556;24292916;8952077;18417395;106
ISIC_0014623;100;2;2;1.0;0.6;2592;1936;5018112;1621655;624463;1621655;1937167;1312704;2246118;83
ISIC_0003657;400;1;2;0.1;0.6;3024;2016;6096384;1808187;0;1808187;340261;340261;1808187;427
ISIC_0007332;150;2;1;100.0;0.6;3024;2016;6096384;5525218;0;5525218;530766;530766;5525218;140
ISIC_0014623;150;3;1;0.01;0.6;2592;1936;5018112;1350221;764277;1350221;1937167;1172890;2114498;151
ISIC_0003657;350;3;2;10.0;0.6;3024;2016;6096384;1613733;2927;1613733;340261;337334;1616660;399
ISIC_0013082;250;3;2;1.0;0.6;3872;2592;10036224;2106196;0;2106196;254836;254836;2106196;278
ISIC_0003657;350;2;2;0.01;0.6;3024;2016;6096384;1736773;10245;1736773;340261;330016;1747018;381
ISIC_0014712;450;1;1;0.1;0.6;6621;4422;29278062;958700;17381369;958700;24292916;6911547;18340069;482
ISIC_0014712;400;3;2;0.1;0.6;6621;4422;29278062;1211999;17841075;1211999;24292916;6451841;19053074;457
ISIC_0003657;100;2;3;1.0;0.6;3024;2016;6096384;2566652;353;2566652;340261;339908;2567005;88
ISIC_0008524;50;4;1;0.1;0.6;4288;2848;12212224;6236545;3290;6236545;323767;320477;6239835;47
ISIC_0013082;200;2;2;10.0;0.6;3872;2592;10036224;2123908;200;2123908;254836;254636;2124108;204
ISIC_0012547;350;2;2;0.1;0.6;4288;2848;12212224;11230790;0;11230790;572681;572681;11230790;382
ISIC_0003657;100;3;2;10.0;0.6;3024;2016;6096384;2439774;30;2439774;340261;340231;2439804;99
ISIC_0014712;250;2;3;0.1;0.6;6621;4422;29278062;1787534;16915911;1787534;24292916;7377005;18703445;267
ISIC_0013082;250;2;3;0.1;0.6;3872;2592;10036224;1903655;4032;1903655;254836;250804;1907687;267
ISIC_0003657;350;3;1;0.01;0.6;3024;2016;6096384;1780382;0;1780382;340261;340261;1780382;391
ISIC_0008524;100;4;2;1.0;0.6;4288;2848;12212224;5108558;1736;5108558;323767;322031;5110294;113
ISIC_0013128;300;1;2;0.01;0.6;3872;2592;10036224;5216357;0;5216357;470897;470897;5216357;306
ISIC_0008524;200;3;1;1.0;0.6;4288;2848;12212224;4644347;10551;4644347;323767;313216;4654898;213
ISIC_0013082;50;2;2;0.01;0.6;3872;2592;10036224;3658774;0;3658774;254836;254836;3658774;21
ISIC_0013082;300;2;3;0.1;0.6;3872;2592;10036224;1885067;7471;1885067;254836;247365;1892538;327
ISIC_0007332;350;1;3;0.01;0.6;3024;2016;6096384;4793452;0;4793452;530766;530766;4793452;371
ISIC_0012547;250;4;1;0.1;0.6;4288;2848;12212224;11532669;47507;11532669;572681;525174;11580176;287
ISIC_0014623;200;2;2;0.1;0.6;2592;1936;5018112;1279163;840343;1279163;1937167;1096824;2119506;202
ISIC_0014623;250;2;1;10.0;0.6;2592;1936;5018112;1266518;966718;1266518;1937167;970449;2233236;259
ISIC_0013128;50;4;1;0.1;0.6;3872;2592;10036224;7108056;0;7108056;470897;470897;7108056;47
ISIC_0014712;450;2;2;10.0;0.6;6621;4422;29278062;1061981;18096632;1061981;24292916;6196284;19158613;504
ISIC_0013128;100;3;3;100.0;0.6;3872;2592;10036224;6560098;0;6560098;470897;470897;6560098;105
ISIC_0014712;350;2;1;0.01;0.6;6621;4422;29278062;1135469;17096128;1135469;24292916;7196788;18231597;376
ISIC_0008524;200;4;1;10.0;0.6;4288;2848;12212224;3962454;11825;3962454;323767;311942;3974279;229
ISIC_0013128;100;1;1;1.0;0.6;3872;2592;10036224;6977127;0;6977127;470897;470897;6977127;63
ISIC_0007332;150;2;3;10.0;0.6;3024;2016;6096384;5525218;0;5525218;530766;530766;5525218;149
ISIC_0003657;250;4;2;0.01;0.6;3024;2016;6096384;1613424;11411;1613424;340261;328850;1624835;291
ISIC_0008524;400;4;3;0.1;0.6;4288;2848;12212224;3172313;3569;3172313;323767;320198;3175882;477
ISIC_0013188;250;2;2;1.0;0.6;3008;2000;6016000;3822355;0;3822355;92544;92544;3822355;263
ISIC_0014428;250;3;2;0.01;0.6;4288;2848;12212224;1323816;0;1323816;525860;525860;1323816;276
ISIC_0014428;100;4;2;1.0;0.6;4288;2848;12212224;2245577;9036;2245577;525860;516824;2254613;113
ISIC_0013188;400;1;1;1.0;0.6;3008;2000;6016000;3233963;0;3233963;92544;92544;3233963;423
ISIC_0013188;450;1;1;0.01;0.6;3008;2000;6016000;3291605;0;3291605;92544;92544;3291605;481
ISIC_0014428;200;3;3;0.1;0.6;4288;2848;12212224;1621410;0;1621410;525860;525860;1621410;222
ISIC_0013188;300;1;1;0.01;0.6;3008;2000;6016000;3841209;0;3841209;92544;92544;3841209;301
ISIC_0007332;250;1;1;10.0;0.6;3024;2016;6096384;5174609;895;5174609;530766;529871;5175504;244
ISIC_0014623;250;3;2;0.1;0.6;2592;1936;5018112;1187363;1027754;1187363;1937167;909413;2215117;277
ISIC_0003657;450;3;2;0.1;0.6;3024;2016;6096384;1499116;0;1499116;340261;340261;1499116;517
ISIC_0007332;100;4;2;10.0;0.6;3024;2016;6096384;0;530766;0;530766;0;530766;114
ISIC_0013188;250;2;3;0.01;0.6;3008;2000;6016000;3914749;1161;3914749;92544;91383;3915910;266
ISIC_0013128;450;1;3;100.0;0.6;3872;2592;10036224;4786514;0;4786514;470897;470897;4786514;495
ISIC_0014712;250;4;1;1.0;0.6;6621;4422;29278062;1784637;17881906;1784637;24292916;6411010;19666543;288
ISIC_0014712;450;2;3;100.0;0.6;6621;4422;29278062;1061978;18096632;1061978;24292916;6196284;19158610;510
ISIC_0013082;50;4;1;100.0;0.6;3872;2592;10036224;3808828;0;3808828;254836;254836;3808828;50
ISIC_0013128;150;2;3;0.1;0.6;3872;2592;10036224;5862093;0;5862093;470897;470897;5862093;147
ISIC_0013128;300;1;1;1.0;0.6;3872;2592;10036224;5178885;55;5178885;470897;470842;5178940;303
ISIC_0013128;100;4;3;0.1;0.6;3872;2592;10036224;6557063;0;6557063;470897;470897;6557063;117
ISIC_0013128;350;1;1;100.0;0.6;3872;2592;10036224;5025987;0;5025987;470897;470897;5025987;365
ISIC_0007332;400;4;1;10.0;0.6;3024;2016;6096384;4766918;0;4766918;530766;530766;4766918;469
ISIC_0014623;450;1;2;0.01;0.6;2592;1936;5018112;1125021;1000000;1125021;1937167;937167;2125021;486
ISIC_0003657;300;1;1;10.0;0.6;3024;2016;6096384;1919008;2337;1919008;340261;337924;1921345;304
ISIC_0014712;100;3;2;0.1;0.6;6621;4422;29278062;3199878;13257524;3199878;24292916;11035392;16457402;97
ISIC_0003657;200;2;2;10.0;0.6;3024;2016;6096384;1934522;304;1934522;340261;339957;1934826;204
ISIC_0014712;50;2;3;10.0;0.6;6621;4422;29278062;2849626;13299678;2849626;24292916;10993238;16149304;29
ISIC_0013188;200;4;2;10.0;0.6;3008;2000;6016000;3977663;0;3977663;92544;92544;3977663;234
ISIC_0008524;150;2;1;100.0;0.6;4288;2848;12212224;4993804;5649;4993804;323767;318118;4999453;140
ISIC_0013128;200;1;1;0.01;0.6;3872;2592;10036224;5822438;0;5822438;470897;470897;5822438;181
ISIC_0007332;200;4;3;10.0;0.6;3024;2016;6096384;5168918;0;5168918;530766;530766;5168918;239
ISIC_0013128;50;2;2;0.1;0.6;3872;2592;10036224;7285821;0;7285821;470897;470897;7285821;22
ISIC_0012547;300;1;3;100.0;0.6;4288;2848;12212224;11388053;0;11388053;572681;572681;11388053;315
ISIC_0013188;350;1;3;0.01;0.6;3008;2000;6016000;3463172;1275;3463172;92544;91269;3464447;371
ISIC_0013188;400;3;3;0.01;0.6;3008;2000;6016000;3110327;1667;3110327;92544;90877;3111994;461
ISIC_0013188;150;2;3;1.0;0.6;3008;2000;6016000;4476854;0;4476854;92544;92544;4476854;148
ISIC_0008524;450;2;2;100.0;0.6;4288;2848;12212224;3870647;18436;3870647;323767;305331;3889083;505
ISIC_0012547;250;1;2;10.0;0.6;4288;2848;12212224;11494346;0;11494346;572681;572681;11494346;249
ISIC_0007332;350;2;1;100.0;0.6;3024;2016;6096384;4871959;0;4871959;530766;530766;4871959;380
ISIC_0014712;350;3;3;10.0;0.6;6621;4422;29278062;1248798;17167266;1248798;24292916;7125650;18416064;404
ISIC_0014428;150;2;3;0.1;0.6;4288;2848;12212224;1753752;0;1753752;525860;525860;1753752;147
ISIC_0003657;250;4;1;0.1;0.6;3024;2016;6096384;1785800;652;1785800;340261;339609;1786452;287
ISIC_0003657;50;4;3;0.1;0.6;3024;2016;6096384;2843792;529;2843792;340261;339732;2844321;57
ISIC_0007332;200;1;1;0.01;0.6;3024;2016;6096384;5254958;0;5254958;530766;530766;5254958;181
ISIC_0008524;150;1;1;10.0;0.6;4288;2848;12212224;4994089;5649;4994089;323767;318118;4999738;124
ISIC_0014623;200;3;1;100.0;0.6;2592;1936;5018112;1235446;919007;1235446;1937167;1018160;2154453;215
ISIC_0014428;450;3;3;0.01;0.6;4288;2848;12212224;709007;11611;709007;525860;514249;720618;521
ISIC_0003657;450;2;3;1.0;0.6;3024;2016;6096384;1550991;1871;1550991;340261;338390;1552862;508
ISIC_0013188;300;3;1;1.0;0.6;3008;2000;6016000;3695914;35;3695914;92544;92509;3695949;333
ISIC_0014623;100;2;3;100.0;0.6;2592;1936;5018112;1582360;624499;1582360;1937167;1312668;2206859;90
ISIC_0007332;50;2;3;10.0;0.6;3024;2016;6096384;5150111;0;5150111;530766;530766;5150111;29
ISIC_0014712;100;3;3;1.0;0.6;6621;4422;29278062;3327282;12430318;3327282;24292916;11862598;15757600;103
ISIC_0012547;50;4;1;10.0;0.6;4288;2848;12212224;10807583;0;10807583;572681;572681;10807583;49
ISIC_0014428;100;1;3;0.1;0.6;4288;2848;12212224;2314048;6;2314048;525860;525854;2314054;72
ISIC_0003657;150;4;1;0.01;0.6;3024;2016;6096384;2169831;0;2169831;340261;340261;2169831;166
ISIC_0012547;100;4;2;100.0;0.6;4288;2848;12212224;0;572681;0;572681;0;572681;115
ISIC_0014712;150;3;1;10.0;0.6;6621;4422;29278062;1997847;15360548;1997847;24292916;8932368;17358395;154
ISIC_0003657;150;3;1;0.1;0.6;3024;2016;6096384;2173745;6881;2173745;340261;333380;2180626;152
ISIC_0014428;400;2;2;0.1;0.6;4288;2848;12212224;899994;11331;899994;525860;514529;911325;442
ISIC_0012547;150;4;3;1.0;0.6;4288;2848;12212224;11558243;0;11558243;572681;572681;11558243;178
ISIC_0003657;300;1;1;0.01;0.6;3024;2016;6096384;2163224;0;2163224;340261;340261;2163224;301
ISIC_0013128;50;3;2;0.1;0.6;3872;2592;10036224;7195061;0;7195061;470897;470897;7195061;37
ISIC_0013082;400;2;2;0.01;0.6;3872;2592;10036224;1490003;39;1490003;254836;254797;1490042;441
ISIC_0012547;100;2;1;0.1;0.6;4288;2848;12212224;0;572681;0;572681;0;572681;77
ISIC_0014428;50;4;1;1.0;0.6;4288;2848;12212224;3159620;1800;3159620;525860;524060;3161420;48
ISIC_0012547;150;4;1;0.01;0.6;4288;2848;12212224;0;572681;0;572681;0;572681;166
ISIC_0008524;200;2;1;100.0;0.6;4288;2848;12212224;4659215;11825;4659215;323767;311942;4671040;200
ISIC_0008524;100;3;2;10.0;0.6;4288;2848;12212224;5531322;4776;5531322;323767;318991;5536098;99
ISIC_0012547;200;3;2;0.01;0.6;4288;2848;12212224;11553199;0;11553199;572681;572681;11553199;216
ISIC_0003657;50;3;1;1.0;0.6;3024;2016;6096384;2300571;56;2300571;340261;340205;2300627;33
ISIC_0008524;350;3;1;10.0;0.6;4288;2848;12212224;4099959;277;4099959;323767;323490;4100236;394
ISIC_0013082;400;3;2;0.1;0.6;3872;2592;10036224;1634231;0;1634231;254836;254836;1634231;457
ISIC_0013082;350;1;2;0.01;0.6;3872;2592;10036224;1658434;9466;1658434;254836;245370;1667900;366
ISIC_0014623;300;3;3;100.0;0.6;2592;1936;5018112;1080944;1094721;1080944;1937167;842446;2175665;345
ISIC_0014428;150;4;3;1.0;0.6;4288;2848;12212224;1902406;0;1902406;525860;525860;1902406;178
ISIC_0013128;300;4;1;0.01;0.6;3872;2592;10036224;5072721;0;5072721;470897;470897;5072721;346
ISIC_0008524;350;4;1;0.1;0.6;4288;2848;12212224;3359284;134;3359284;323767;323633;3359418;407
ISIC_0014712;250;3;3;0.1;0.6;6621;4422;29278062;1787422;17157631;1787422;24292916;7135285;18945053;282
ISIC_0014712;400;1;3;1.0;0.6;6621;4422;29278062;1404224;16479070;1404224;24292916;7813846;17883294;433
ISIC_0013188;400;4;3;0.01;0.6;3008;2000;6016000;3087336;1612;3087336;92544;90932;3088948;476
ISIC_0014428;100;4;3;100.0;0.6;4288;2848;12212224;2370783;534;2370783;525860;525326;2371317;120
ISIC_0007332;250;3;1;0.01;0.6;3024;2016;6096384;5125782;0;5125782;530766;530766;5125782;271
ISIC_0008524;200;1;2;10.0;0.6;4288;2848;12212224;4726491;11825;4726491;323767;311942;4738316;189
ISIC_0014712;250;1;3;0.01;0.6;6621;4422;29278062;1680693;15884533;1680693;24292916;8408383;17565226;251
ISIC_0008524;450;2;2;0.1;0.6;4288;2848;12212224;3916243;9967;3916243;323767;313800;3926210;502
ISIC_0013128;100;4;2;1.0;0.6;3872;2592;10036224;6459037;0;6459037;470897;470897;6459037;113
ISIC_0013082;200;3;1;1.0;0.6;3872;2592;10036224;2086944;524;2086944;254836;254312;2087468;213
ISIC_0014712;400;4;2;0.1;0.6;6621;4422;29278062;1198723;19246736;1198723;24292916;5046180;20445459;472
ISIC_0003657;450;4;2;0.1;0.6;3024;2016;6096384;1460741;0;1460741;340261;340261;1460741;532
ISIC_0014712;450;4;3;100.0;0.6;6621;4422;29278062;1058236;19009863;1058236;24292916;5283053;20068099;540
ISIC_0013082;300;3;1;100.0;0.6;3872;2592;10036224;2200671;224;2200671;254836;254612;2200895;335
ISIC_0013128;400;1;2;1.0;0.6;3872;2592;10036224;4736242;0;4736242;470897;470897;4736242;428
ISIC_0012547;50;3;2;10.0;0.6;4288;2848;12212224;10811912;0;10811912;572681;572681;10811912;39
ISIC_0013082;250;2;2;1.0;0.6;3872;2592;10036224;2106107;0;2106107;254836;254836;2106107;263
ISIC_0014712;400;2;3;1.0;0.6;6621;4422;29278062;1315878;17585614;1315878;24292916;6707302;18901492;448
ISIC_0012547;250;1;3;1.0;0.6;4288;2848;12212224;11493633;0;11493633;572681;572681;11493633;253
ISIC_0012547;450;1;1;0.01;0.6;4288;2848;12212224;11405523;41222;11405523;572681;531459;11446745;481
ISIC_0008524;450;2;2;10.0;0.6;4288;2848;12212224;3870647;18436;3870647;323767;305331;3889083;504
ISIC_0013082;200;1;3;10.0;0.6;3872;2592;10036224;2123915;200;2123915;254836;254636;2124115;194
ISIC_0013128;300;3;1;1.0;0.6;3872;2592;10036224;5070949;55;5070949;470897;470842;5071004;333
ISIC_0008524;150;4;1;0.1;0.6;4288;2848;12212224;4495856;0;4495856;323767;323767;4495856;167
ISIC_0007332;450;2;3;0.1;0.6;3024;2016;6096384;4577724;876;4577724;530766;529890;4578600;507
ISIC_0014623;200;1;1;100.0;0.6;2592;1936;5018112;1416049;743803;1416049;1937167;1193364;2159852;185
ISIC_0013082;450;1;3;0.1;0.6;3872;2592;10036224;1529423;1579;1529423;254836;253257;1531002;492
ISIC_0013128;200;4;2;10.0;0.6;3872;2592;10036224;5464777;0;5464777;470897;470897;5464777;234
ISIC_0008524;350;1;2;10.0;0.6;4288;2848;12212224;4242442;277;4242442;323767;323490;4242719;369
ISIC_0013128;50;2;2;100.0;0.6;3872;2592;10036224;6971240;0;6971240;470897;470897;6971240;25
ISIC_0014623;100;4;2;10.0;0.6;2592;1936;5018112;1496042;767922;1496042;1937167;1169245;2263964;114
ISIC_0014428;150;3;3;0.01;0.6;4288;2848;12212224;1804033;12195;1804033;525860;513665;1816228;161
ISIC_0003657;250;4;3;0.01;0.6;3024;2016;6096384;1618468;11874;1618468;340261;328387;1630342;296
ISIC_0013082;350;4;1;10.0;0.6;3872;2592;10036224;1955526;0;1955526;254836;254836;1955526;409
ISIC_0007332;350;2;3;0.1;0.6;3024;2016;6096384;4755230;69;4755230;530766;530697;4755299;387
ISIC_0007332;350;4;1;0.01;0.6;3024;2016;6096384;4913359;0;4913359;530766;530766;4913359;406
ISIC_0013082;200;2;2;0.01;0.6;3872;2592;10036224;2452716;0;2452716;254836;254836;2452716;201
ISIC_0014428;100;4;2;10.0;0.6;4288;2848;12212224;2370990;539;2370990;525860;525321;2371529;114
ISIC_0008524;200;2;2;0.01;0.6;4288;2848;12212224;4857282;0;4857282;323767;323767;4857282;201
ISIC_0007332;400;2;3;1.0;0.6;3024;2016;6096384;4811971;0;4811971;530766;530766;4811971;448
ISIC_0003657;200;3;3;100.0;0.6;3024;2016;6096384;1786910;1527;1786910;340261;338734;1788437;225
ISIC_0012547;100;2;2;0.1;0.6;4288;2848;12212224;0;572681;0;572681;0;572681;82
ISIC_0003657;50;3;2;100.0;0.6;3024;2016;6096384;2192235;72;2192235;340261;340189;2192307;40
ISIC_0012547;250;1;3;10.0;0.6;4288;2848;12212224;11494346;0;11494346;572681;572681;11494346;254
ISIC_0013188;400;4;1;10.0;0.6;3008;2000;6016000;3250018;0;3250018;92544;92544;3250018;469
ISIC_0014712;350;2;2;1.0;0.6;6621;4422;29278062;1252250;17087646;1252250;24292916;7205270;18339896;383
ISIC_0003657;450;4;3;10.0;0.6;3024;2016;6096384;1372809;1807;1372809;340261;338454;1374616;539
ISIC_0014428;300;3;3;100.0;0.6;4288;2848;12212224;1211476;1843;1211476;525860;524017;1213319;345
ISIC_0007332;300;3;1;100.0;0.6;3024;2016;6096384;5109013;0;5109013;530766;530766;5109013;335
ISIC_0012547;100;3;1;0.01;0.6;4288;2848;12212224;0;572681;0;572681;0;572681;91
ISIC_0012547;150;4;1;10.0;0.6;4288;2848;12212224;11558318;0;11558318;572681;572681;11558318;169
ISIC_0014712;150;2;2;1.0;0.6;6621;4422;29278062;1999260;15165274;1999260;24292916;9127642;17164534;143
ISIC_0012547;150;3;2;0.1;0.6;4288;2848;12212224;11550577;0;11550577;572681;572681;11550577;157
ISIC_0013188;100;1;1;10.0;0.6;3008;2000;6016000;4864412;0;4864412;92544;92544;4864412;64
ISIC_0007332;350;3;2;100.0;0.6;3024;2016;6096384;4872093;0;4872093;530766;530766;4872093;400
ISIC_0007332;50;1;3;1.0;0.6;3024;2016;6096384;5117343;0;5117343;530766;530766;5117343;13
ISIC_0007332;300;4;1;0.01;0.6;3024;2016;6096384;5055141;0;5055141;530766;530766;5055141;346
ISIC_0013128;450;4;2;0.01;0.6;3872;2592;10036224;4547493;0;4547493;470897;470897;4547493;531
ISIC_0003657;200;4;1;100.0;0.6;3024;2016;6096384;1662506;1959;1662506;340261;338302;1664465;230
ISIC_0014428;50;2;1;10.0;0.6;4288;2848;12212224;2715613;1211;2715613;525860;524649;2716824;19
ISIC_0003657;400;1;2;100.0;0.6;3024;2016;6096384;1781094;3890;1781094;340261;336371;1784984;430
ISIC_0014712;350;2;3;10.0;0.6;6621;4422;29278062;1252948;17087599;1252948;24292916;7205317;18340547;389
ISIC_0007332;50;4;1;100.0;0.6;3024;2016;6096384;5142837;0;5142837;530766;530766;5142837;50
ISIC_0013082;150;3;3;0.01;0.6;3872;2592;10036224;2298967;6696;2298967;254836;248140;2305663;161
ISIC_0008524;100;4;1;0.01;0.6;4288;2848;12212224;5801403;1834;5801403;323767;321933;5803237;106
ISIC_0008524;250;3;1;10.0;0.6;4288;2848;12212224;4328086;7441;4328086;323767;316326;4335527;274
ISIC_0003657;400;2;1;0.1;0.6;3024;2016;6096384;1668698;0;1668698;340261;340261;1668698;437
ISIC_0008524;400;2;2;1.0;0.6;4288;2848;12212224;4010582;3654;4010582;323767;320113;4014236;443
ISIC_0014712;250;3;3;100.0;0.6;6621;4422;29278062;1784884;17066003;1784884;24292916;7226913;18850887;285
ISIC_0013128;400;1;3;0.01;0.6;3872;2592;10036224;4738350;0;4738350;470897;470897;4738350;431
ISIC_0014428;400;2;3;0.1;0.6;4288;2848;12212224;866964;10425;866964;525860;515435;877389;447
ISIC_0013128;400;1;1;10.0;0.6;3872;2592;10036224;4736367;0;4736367;470897;470897;4736367;424
ISIC_0013128;350;3;1;0.01;0.6;3872;2592;10036224;4967036;0;4967036;470897;470897;4967036;391
ISIC_0003657;350;2;3;10.0;0.6;3024;2016;6096384;1646875;2927;1646875;340261;337334;1649802;389
ISIC_0014623;450;2;1;1.0;0.6;2592;1936;5018112;1000847;1110922;1000847;1937167;826245;2111769;498
ISIC_0003657;250;4;1;10.0;0.6;3024;2016;6096384;1668813;296;1668813;340261;339965;1669109;289
ISIC_0013188;50;2;1;1.0;0.6;3008;2000;6016000;5071121;0;5071121;92544;92544;5071121;18
ISIC_0012547;100;1;2;10.0;0.6;4288;2848;12212224;0;572681;0;572681;0;572681;69
ISIC_0014623;300;2;2;0.1;0.6;2592;1936;5018112;1105487;1046254;1105487;1937167;890913;2151741;322
ISIC_0007332;50;3;3;0.1;0.6;3024;2016;6096384;5239297;0;5239297;530766;530766;5239297;42
ISIC_0013188;300;3;1;100.0;0.6;3008;2000;6016000;3695991;45;3695991;92544;92499;3696036;335
ISIC_0013082;300;4;3;100.0;0.6;3872;2592;10036224;2201192;224;2201192;254836;254612;2201416;360
ISIC_0007332;350;4;1;100.0;0.6;3024;2016;6096384;4854535;0;4854535;530766;530766;4854535;410
ISIC_0008524;300;1;3;0.01;0.6;4288;2848;12212224;4508905;203;4508905;323767;323564;4509108;311
ISIC_0014428;200;3;1;10.0;0.6;4288;2848;12212224;1500192;999;1500192;525860;524861;1501191;214
ISIC_0014712;200;2;1;10.0;0.6;6621;4422;29278062;1408737;16226780;1408737;24292916;8066136;17635517;199
ISIC_0014428;250;2;1;10.0;0.6;4288;2848;12212224;1366468;4628;1366468;525860;521232;1371096;259
ISIC_0012547;200;4;2;1.0;0.6;4288;2848;12212224;11263510;61666;11263510;572681;511015;11325176;233
ISIC_0013188;50;1;1;0.01;0.6;3008;2000;6016000;5521907;0;5521907;92544;92544;5521907;1
ISIC_0012547;450;2;1;1.0;0.6;4288;2848;12212224;11253560;54450;11253560;572681;518231;11308010;498
ISIC_0013188;350;4;2;100.0;0.6;3008;2000;6016000;3509674;0;3509674;92544;92544;3509674;415
ISIC_0003657;200;1;3;10.0;0.6;3024;2016;6096384;2128336;304;2128336;340261;339957;2128640;194
ISIC_0014712;100;3;3;10.0;0.6;6621;4422;29278062;3327019;12430712;3327019;24292916;11862204;15757731;104
ISIC_0012547;300;1;3;0.1;0.6;4288;2848;12212224;11368596;0;11368596;572681;572681;11368596;312
ISIC_0014712;150;1;1;100.0;0.6;6621;4422;29278062;2009579;13809811;2009579;24292916;10483105;15819390;125
ISIC_0003657;350;2;1;100.0;0.6;3024;2016;6096384;1647066;2927;1647066;340261;337334;1649993;380
ISIC_0003657;400;1;2;0.01;0.6;3024;2016;6096384;1735380;12375;1735380;340261;327886;1747755;426
ISIC_0014623;50;4;3;100.0;0.6;2592;1936;5018112;2054883;436700;2054883;1937167;1500467;2491583;60
ISIC_0013128;450;4;1;0.01;0.6;3872;2592;10036224;4666702;0;4666702;470897;470897;4666702;526
ISIC_0012547;300;2;2;0.1;0.6;4288;2848;12212224;11420087;0;11420087;572681;572681;11420087;322
ISIC_0013082;150;2;3;0.01;0.6;3872;2592;10036224;2310349;6779;2310349;254836;248057;2317128;146
ISIC_0013188;300;3;3;1.0;0.6;3008;2000;6016000;3716314;35;3716314;92544;92509;3716349;343
ISIC_0013188;150;1;3;0.1;0.6;3008;2000;6016000;4477181;0;4477181;92544;92544;4477181;132
ISIC_0013128;400;4;3;100.0;0.6;3872;2592;10036224;4483393;0;4483393;470897;470897;4483393;480
ISIC_0013188;50;1;2;1.0;0.6;3008;2000;6016000;5071216;0;5071216;92544;92544;5071216;8
ISIC_0014428;400;1;1;10.0;0.6;4288;2848;12212224;1256710;1424;1256710;525860;524436;1258134;424
ISIC_0008524;400;4;1;0.01;0.6;4288;2848;12212224;3236484;1388;3236484;323767;322379;3237872;466
ISIC_0008524;350;4;1;100.0;0.6;4288;2848;12212224;3333250;277;3333250;323767;323490;3333527;410
ISIC_0013082;250;2;1;1.0;0.6;3872;2592;10036224;2066559;0;2066559;254836;254836;2066559;258
ISIC_0014623;400;4;1;100.0;0.6;2592;1936;5018112;976464;1143080;976464;1937167;794087;2119544;470
ISIC_0014428;100;4;3;0.1;0.6;4288;2848;12212224;2051212;37;2051212;525860;525823;2051249;117
ISIC_0008524;400;4;2;0.01;0.6;4288;2848;12212224;3183300;11590;3183300;323767;312177;3194890;471
ISIC_0013082;100;2;1;0.01;0.6;3872;2592;10036224;3526345;0;3526345;254836;254836;3526345;76
ISIC_0012547;300;3;3;10.0;0.6;4288;2848;12212224;11305031;81608;11305031;572681;491073;11386639;344
ISIC_0013128;150;4;2;100.0;0.6;3872;2592;10036224;5678272;0;5678272;470897;470897;5678272;175
ISIC_0007332;450;4;2;0.1;0.6;3024;2016;6096384;4626404;0;4626404;530766;530766;4626404;532
ISIC_0013188;100;4;1;100.0;0.6;3008;2000;6016000;4739063;0;4739063;92544;92544;4739063;110
ISIC_0013188;100;1;1;0.01;0.6;3008;2000;6016000;5027932;0;5027932;92544;92544;5027932;61
ISIC_0003657;50;1;3;0.01;0.6;3024;2016;6096384;3769217;11169;3769217;340261;329092;3780386;11
ISIC_0013082;350;4;1;100.0;0.6;3872;2592;10036224;1955511;0;1955511;254836;254836;1955511;410
ISIC_0013188;150;3;1;100.0;0.6;3008;2000;6016000;4477347;0;4477347;92544;92544;4477347;155
ISIC_0013082;400;3;2;1.0;0.6;3872;2592;10036224;1813919;0;1813919;254836;254836;1813919;458
ISIC_0007332;300;1;2;1.0;0.6;3024;2016;6096384;5088433;0;5088433;530766;530766;5088433;308
ISIC_0014623;100;3;1;0.01;0.6;2592;1936;5018112;1664109;742945;1664109;1937167;1194222;2407054;91
ISIC_0013082;50;4;3;1.0;0.6;3872;2592;10036224;3805398;0;3805398;254836;254836;3805398;58
ISIC_0008524;400;4;2;100.0;0.6;4288;2848;12212224;3131169;13085;3131169;323767;310682;3144254;475
ISIC_0014712;350;3;1;100.0;0.6;6621;4422;29278062;1248104;17167495;1248104;24292916;7125421;18415599;395
ISIC_0014623;300;1;3;10.0;0.6;2592;1936;5018112;1226451;956160;1226451;1937167;981007;2182611;314
ISIC_0007332;350;1;3;10.0;0.6;3024;2016;6096384;4871965;0;4871965;530766;530766;4871965;374
ISIC_0013188;400;1;3;1.0;0.6;3008;2000;6016000;3249653;0;3249653;92544;92544;3249653;433
ISIC_0013128;300;4;1;0.1;0.6;3872;2592;10036224;4956673;0;4956673;470897;470897;4956673;347
ISIC_0007332;250;4;1;1.0;0.6;3024;2016;6096384;5150772;895;5150772;530766;529871;5151667;288
ISIC_0007332;350;2;1;10.0;0.6;3024;2016;6096384;4871959;0;4871959;530766;530766;4871959;379
ISIC_0008524;100;1;2;100.0;0.6;4288;2848;12212224;5653347;4774;5653347;323767;318993;5658121;70
ISIC_0014712;450;3;2;10.0;0.6;6621;4422;29278062;1061981;18360557;1061981;24292916;5932359;19422538;519
ISIC_0013128;150;1;3;0.01;0.6;3872;2592;10036224;6386918;0;6386918;470897;470897;6386918;131
ISIC_0012547;250;2;1;100.0;0.6;4288;2848;12212224;11494346;0;11494346;572681;572681;11494346;260
ISIC_0003657;150;1;2;0.1;0.6;3024;2016;6096384;2410031;0;2410031;340261;340261;2410031;127
ISIC_0014712;350;2;1;0.1;0.6;6621;4422;29278062;1132067;17364032;1132067;24292916;6928884;18496099;377
ISIC_0013082;300;1;1;10.0;0.6;3872;2592;10036224;2200750;224;2200750;254836;254612;2200974;304
ISIC_0014623;300;4;1;0.1;0.6;2592;1936;5018112;1006940;1130022;1006940;1937167;807145;2136962;347
ISIC_0014712;300;4;2;0.01;0.6;6621;4422;29278062;1326685;18357447;1326685;24292916;5935469;19684132;351
ISIC_0007332;400;2;2;1.0;0.6;3024;2016;6096384;4811979;0;4811979;530766;530766;4811979;443
ISIC_0013082;400;4;2;0.1;0.6;3872;2592;10036224;1657925;0;1657925;254836;254836;1657925;472
ISIC_0013188;400;1;2;1.0;0.6;3008;2000;6016000;3249395;0;3249395;92544;92544;3249395;428
ISIC_0007332;100;1;2;1.0;0.6;3024;2016;6096384;0;530766;0;530766;0;530766;68
ISIC_0014712;150;2;1;0.1;0.6;6621;4422;29278062;1941300;15410291;1941300;24292916;8882625;17351591;137
ISIC_0003657;100;3;3;10.0;0.6;3024;2016;6096384;2440060;30;2440060;340261;340231;2440090;104
ISIC_0003657;250;3;3;100.0;0.6;3024;2016;6096384;1746023;296;1746023;340261;339965;1746319;285
ISIC_0014428;350;4;3;0.01;0.6;4288;2848;12212224;936025;4497;936025;525860;521363;940522;416
ISIC_0014428;450;1;1;0.01;0.6;4288;2848;12212224;1086822;91;1086822;525860;525769;1086913;481
ISIC_0014623;150;4;2;100.0;0.6;2592;1936;5018112;1308179;887003;1308179;1937167;1050164;2195182;175
ISIC_0013128;100;2;2;1.0;0.6;3872;2592;10036224;6775373;0;6775373;470897;470897;6775373;83
ISIC_0014623;300;1;2;100.0;0.6;2592;1936;5018112;1226232;956160;1226232;1937167;981007;2182392;310
ISIC_0008524;400;4;3;0.01;0.6;4288;2848;12212224;3221335;10963;3221335;323767;312804;3232298;476
ISIC_0013082;300;1;3;0.1;0.6;3872;2592;10036224;1826265;3564;1826265;254836;251272;1829829;312
ISIC_0003657;350;4;1;100.0;0.6;3024;2016;6096384;1523855;2927;1523855;340261;337334;1526782;410
ISIC_0012547;150;1;3;10.0;0.6;4288;2848;12212224;11558318;0;11558318;572681;572681;11558318;134
ISIC_0014712;200;1;2;0.01;0.6;6621;4422;29278062;1660151;14660577;1660151;24292916;9632339;16320728;186
ISIC_0013128;150;4;1;100.0;0.6;3872;2592;10036224;5678264;0;5678264;470897;470897;5678264;170
ISIC_0013082;300;1;3;100.0;0.6;3872;2592;10036224;2201353;224;2201353;254836;254612;2201577;315
ISIC_0013128;50;1;3;0.1;0.6;3872;2592;10036224;7283702;0;7283702;470897;470897;7283702;12
ISIC_0007332;450;1;1;0.01;0.6;3024;2016;6096384;4707877;0;4707877;530766;530766;4707877;481
ISIC_0014428;200;3;1;0.1;0.6;4288;2848;12212224;1622279;0;1622279;525860;525860;1622279;212
ISIC_0003657;300;1;2;0.01;0.6;3024;2016;6096384;2076092;10824;2076092;340261;329437;2086916;306
ISIC_0014428;150;1;3;100.0;0.6;4288;2848;12212224;2154405;990;2154405;525860;524870;2155395;135
ISIC_0014428;300;3;2;0.01;0.6;4288;2848;12212224;1269965;2481;1269965;525860;523379;1272446;336
ISIC_0013082;450;1;2;100.0;0.6;3872;2592;10036224;1722804;1608;1722804;254836;253228;1724412;490
ISIC_0012547;350;3;3;0.1;0.6;4288;2848;12212224;11233018;38995;11233018;572681;533686;11272013;402
ISIC_0013082;150;2;2;10.0;0.6;3872;2592;10036224;2759696;183;2759696;254836;254653;2759879;144
ISIC_0003657;450;4;3;0.01;0.6;3024;2016;6096384;1341720;21762;1341720;340261;318499;1363482;536
ISIC_0008524;350;1;2;100.0;0.6;4288;2848;12212224;4242442;277;4242442;323767;323490;4242719;370
ISIC_0014712;50;2;2;1.0;0.6;6621;4422;29278062;2466014;12862363;2466014;24292916;11430553;15328377;23
ISIC_0013128;200;1;1;100.0;0.6;3872;2592;10036224;5755525;0;5755525;470897;470897;5755525;185
ISIC_0012547;300;2;2;10.0;0.6;4288;2848;12212224;11388053;40804;11388053;572681;531877;11428857;324
ISIC_0007332;400;3;2;1.0;0.6;3024;2016;6096384;4812095;0;4812095;530766;530766;4812095;458
ISIC_0003657;450;3;1;0.01;0.6;3024;2016;6096384;1553370;0;1553370;340261;340261;1553370;511
ISIC_0012547;350;4;1;0.1;0.6;4288;2848;12212224;11237709;111866;11237709;572681;460815;11349575;407
ISIC_0013188;350;2;3;10.0;0.6;3008;2000;6016000;3510357;0;3510357;92544;92544;3510357;389
ISIC_0003657;100;2;1;100.0;0.6;3024;2016;6096384;2565218;30;2565218;340261;340231;2565248;80
ISIC_0013082;150;4;2;1.0;0.6;3872;2592;10036224;2689751;2849;2689751;254836;251987;2692600;173
ISIC_0013082;450;3;3;0.1;0.6;3872;2592;10036224;1477675;1544;1477675;254836;253292;1479219;522
ISIC_0007332;150;4;1;0.1;0.6;3024;2016;6096384;5481258;0;5481258;530766;530766;5481258;167
ISIC_0007332;150;2;3;0.01;0.6;3024;2016;6096384;5472753;0;5472753;530766;530766;5472753;146
ISIC_0012547;450;3;2;100.0;0.6;4288;2848;12212224;11227043;108900;11227043;572681;463781;11335943;520
ISIC_0013188;200;1;2;100.0;0.6;3008;2000;6016000;4007593;0;4007593;92544;92544;4007593;190
ISIC_0013128;350;4;2;1.0;0.6;3872;2592;10036224;4754311;0;4754311;470897;470897;4754311;413
ISIC_0014428;300;1;3;10.0;0.6;4288;2848;12212224;1337728;1843;1337728;525860;524017;1339571;314
ISIC_0007332;200;3;1;1.0;0.6;3024;2016;6096384;5168939;0;5168939;530766;530766;5168939;213
ISIC_0014712;300;1;1;10.0;0.6;6621;4422;29278062;1326287;15822066;1326287;24292916;8470850;17148353;304
ISIC_0014428;450;1;3;0.01;0.6;4288;2848;12212224;883013;3042;883013;525860;522818;886055;491
ISIC_0007332;300;3;2;10.0;0.6;3024;2016;6096384;5087997;0;5087997;530766;530766;5087997;339
ISIC_0014428;300;4;2;100.0;0.6;4288;2848;12212224;1211474;1843;1211474;525860;524017;1213317;355
ISIC_0012547;450;3;3;100.0;0.6;4288;2848;12212224;11227043;108900;11227043;572681;463781;11335943;525
ISIC_0014712;100;4;3;0.01;0.6;6621;4422;29278062;3074174;15344234;3074174;24292916;8948682;18418408;116
ISIC_0013188;200;2;3;10.0;0.6;3008;2000;6016000;4007610;0;4007610;92544;92544;4007610;209
ISIC_0014428;450;2;1;0.01;0.6;4288;2848;12212224;930649;70;930649;525860;525790;930719;496
ISIC_0003657;450;2;1;100.0;0.6;3024;2016;6096384;1551053;1807;1551053;340261;338454;1552860;500
ISIC_0014623;250;2;3;0.01;0.6;2592;1936;5018112;1280359;910585;1280359;1937167;1026582;2190944;266
ISIC_0013082;100;4;1;1.0;0.6;3872;2592;10036224;2997870;0;2997870;254836;254836;2997870;108
ISIC_0014428;350;4;2;0.1;0.6;4288;2848;12212224;1024238;0;1024238;525860;525860;1024238;412
ISIC_0003657;300;2;1;100.0;0.6;3024;2016;6096384;1706456;2337;1706456;340261;337924;1708793;320
ISIC_0012547;200;2;1;100.0;0.6;4288;2848;12212224;11252318;0;11252318;572681;572681;11252318;200
ISIC_0013188;150;1;1;0.01;0.6;3008;2000;6016000;4602530;0;4602530;92544;92544;4602530;121
ISIC_0013188;100;3;1;0.01;0.6;3008;2000;6016000;4964336;0;4964336;92544;92544;4964336;91
ISIC_0008524;50;1;2;100.0;0.6;4288;2848;12212224;6157223;12028;6157223;323767;311739;6169251;10
ISIC_0014428;200;2;1;1.0;0.6;4288;2848;12212224;1287357;3147;1287357;525860;522713;1290504;198
ISIC_0008524;250;4;1;10.0;0.6;4288;2848;12212224;3692061;7441;3692061;323767;316326;3699502;289
ISIC_0014428;150;3;3;1.0;0.6;4288;2848;12212224;1986333;0;1986333;525860;525860;1986333;163
ISIC_0014623;150;2;3;0.1;0.6;2592;1936;5018112;1581603;730516;1581603;1937167;1206651;2312119;147
ISIC_0003657;350;4;3;100.0;0.6;3024;2016;6096384;1523820;2927;1523820;340261;337334;1526747;420
ISIC_0014712;450;4;3;10.0;0.6;6621;4422;29278062;1058236;19009863;1058236;24292916;5283053;20068099;539
ISIC_0014428;450;1;2;1.0;0.6;4288;2848;12212224;1257343;1282;1257343;525860;524578;1258625;488
ISIC_0012547;100;1;1;0.1;0.6;4288;2848;12212224;0;572681;0;572681;0;572681;62
ISIC_0012547;200;3;1;100.0;0.6;4288;2848;12212224;11252316;0;11252316;572681;572681;11252316;215
ISIC_0014623;200;3;2;0.1;0.6;2592;1936;5018112;1186984;872352;1186984;1937167;1064815;2059336;217
ISIC_0007332;100;1;3;0.1;0.6;3024;2016;6096384;0;530766;0;530766;0;530766;72
ISIC_0008524;450;2;3;0.1;0.6;4288;2848;12212224;3883728;11991;3883728;323767;311776;3895719;507
ISIC_0013128;350;2;3;0.01;0.6;3872;2592;10036224;4970427;0;4970427;470897;470897;4970427;386
ISIC_0003657;50;3;2;0.1;0.6;3024;2016;6096384;3065878;450;3065878;340261;339811;3066328;37
ISIC_0014623;250;1;2;0.1;0.6;2592;1936;5018112;1385485;922940;1385485;1937167;1014227;2308425;247
ISIC_0013188;50;3;2;100.0;0.6;3008;2000;6016000;5061945;0;5061945;92544;92544;5061945;40
ISIC_0013128;100;1;3;100.0;0.6;3872;2592;10036224;6977542;0;6977542;470897;470897;6977542;75
ISIC_0014428;450;2;2;1.0;0.6;4288;2848;12212224;1176404;1322;1176404;525860;524538;1177726;503
ISIC_0014428;450;1;2;0.1;0.6;4288;2848;12212224;981313;0;981313;525860;525860;981313;487
ISIC_0013128;350;2;2;10.0;0.6;3872;2592;10036224;4996106;0;4996106;470897;470897;4996106;384
ISIC_0003657;150;4;2;1.0;0.6;3024;2016;6096384;1891586;2142;1891586;340261;338119;1893728;173
ISIC_0007332;400;1;1;0.01;0.6;3024;2016;6096384;4836291;0;4836291;530766;530766;4836291;421
ISIC_0007332;150;4;2;0.1;0.6;3024;2016;6096384;5480165;0;5480165;530766;530766;5480165;172
ISIC_0014428;200;1;2;1.0;0.6;4288;2848;12212224;1467381;2881;1467381;525860;522979;1470262;188
ISIC_0013082;300;4;2;10.0;0.6;3872;2592;10036224;2200860;224;2200860;254836;254612;2201084;354
ISIC_0014623;450;2;3;10.0;0.6;2592;1936;5018112;1000667;1111210;1000667;1937167;825957;2111877;509
ISIC_0013082;300;4;1;1.0;0.6;3872;2592;10036224;2130996;1650;2130996;254836;253186;2132646;348
ISIC_0014712;150;3;3;0.1;0.6;6621;4422;29278062;1941837;15600122;1941837;24292916;8692794;17541959;162
ISIC_0003657;200;3;1;10.0;0.6;3024;2016;6096384;1814201;1527;1814201;340261;338734;1815728;214
ISIC_0012547;150;1;2;10.0;0.6;4288;2848;12212224;11558318;0;11558318;572681;572681;11558318;129
ISIC_0008524;350;3;1;100.0;0.6;4288;2848;12212224;4099959;277;4099959;323767;323490;4100236;395
ISIC_0007332;50;2;1;0.1;0.6;3024;2016;6096384;5356193;0;5356193;530766;530766;5356193;17
ISIC_0003657;300;3;3;1.0;0.6;3024;2016;6096384;1582218;2490;1582218;340261;337771;1584708;343
ISIC_0007332;50;1;2;100.0;0.6;3024;2016;6096384;5142952;0;5142952;530766;530766;5142952;10
ISIC_0008524;100;1;2;10.0;0.6;4288;2848;12212224;5653239;4776;5653239;323767;318991;5658015;69
ISIC_0013188;350;3;2;100.0;0.6;3008;2000;6016000;3509675;0;3509675;92544;92544;3509675;400
ISIC_0014428;200;1;3;1.0;0.6;4288;2848;12212224;1467605;2881;1467605;525860;522979;1470486;193
ISIC_0012547;400;1;2;0.01;0.6;4288;2848;12212224;11408187;0;11408187;572681;572681;11408187;426
ISIC_0014623;400;2;1;100.0;0.6;2592;1936;5018112;1079228;1079388;1079228;1937167;857779;2158616;440
ISIC_0013188;50;2;2;1.0;0.6;3008;2000;6016000;5071173;0;5071173;92544;92544;5071173;23
ISIC_0012547;350;2;3;10.0;0.6;4288;2848;12212224;11254078;36400;11254078;572681;536281;11290478;389
ISIC_0013188;300;1;1;100.0;0.6;3008;2000;6016000;3695991;45;3695991;92544;92499;3696036;305
ISIC_0014428;200;1;1;100.0;0.6;4288;2848;12212224;1568875;999;1568875;525860;524861;1569874;185
ISIC_0014712;200;1;2;0.1;0.6;6621;4422;29278062;1528898;15121293;1528898;24292916;9171623;16650191;187
ISIC_0013188;100;1;3;0.01;0.6;3008;2000;6016000;4998746;0;4998746;92544;92544;4998746;71
ISIC_0003657;100;2;2;100.0;0.6;3024;2016;6096384;2565467;30;2565467;340261;340231;2565497;85
ISIC_0013082;200;4;3;0.1;0.6;3872;2592;10036224;2147037;1807;2147037;254836;253029;2148844;237
ISIC_0014623;100;3;1;100.0;0.6;2592;1936;5018112;1573660;719345;1573660;1937167;1217822;2293005;95
ISIC_0014623;100;4;1;0.1;0.6;2592;1936;5018112;1700724;705325;1700724;1937167;1231842;2406049;107
ISIC_0014623;150;3;3;1.0;0.6;2592;1936;5018112;1340864;886734;1340864;1937167;1050433;2227598;163
ISIC_0007332;150;3;2;10.0;0.6;3024;2016;6096384;5525218;0;5525218;530766;530766;5525218;159
ISIC_0013082;250;1;3;0.01;0.6;3872;2592;10036224;1832968;9055;1832968;254836;245781;1842023;251
ISIC_0013188;150;1;2;0.01;0.6;3008;2000;6016000;4568308;0;4568308;92544;92544;4568308;126
ISIC_0014428;400;4;1;0.01;0.6;4288;2848;12212224;1119023;1;1119023;525860;525859;1119024;466
ISIC_0014712;150;4;1;0.01;0.6;6621;4422;29278062;1695466;15982701;1695466;24292916;8310215;17678167;166
ISIC_0013082;50;3;3;0.1;0.6;3872;2592;10036224;3454301;2129;3454301;254836;252707;3456430;42
ISIC_0014712;200;1;3;100.0;0.6;6621;4422;29278062;1419760;14624015;1419760;24292916;9668901;16043775;195
ISIC_0014712;450;1;3;10.0;0.6;6621;4422;29278062;1065548;17186282;1065548;24292916;7106634;18251830;494
ISIC_0008524;150;1;1;1.0;0.6;4288;2848;12212224;5141277;2556;5141277;323767;321211;5143833;123
ISIC_0003657;400;3;2;100.0;0.6;3024;2016;6096384;1539142;3890;1539142;340261;336371;1543032;460
ISIC_0013128;200;1;1;1.0;0.6;3872;2592;10036224;5712131;0;5712131;470897;470897;5712131;183
ISIC_0013188;400;1;1;0.1;0.6;3008;2000;6016000;3218279;0;3218279;92544;92544;3218279;422
ISIC_0014623;50;4;1;0.01;0.6;2592;1936;5018112;2123183;488468;2123183;1937167;1448699;2611651;46
ISIC_0013128;350;4;1;1.0;0.6;3872;2592;10036224;4754176;0;4754176;470897;470897;4754176;408
ISIC_0008524;50;3;3;0.1;0.6;4288;2848;12212224;7390635;0;7390635;323767;323767;7390635;42
ISIC_0013188;100;3;3;0.1;0.6;3008;2000;6016000;4861853;0;4861853;92544;92544;4861853;102
ISIC_0013082;250;3;3;0.01;0.6;3872;2592;10036224;1919335;11753;1919335;254836;243083;1931088;281
ISIC_0012547;400;3;2;0.01;0.6;4288;2848;12212224;11359452;84667;11359452;572681;488014;11444119;456
ISIC_0013188;450;3;1;1.0;0.6;3008;2000;6016000;3152591;355;3152591;92544;92189;3152946;513
ISIC_0008524;200;2;1;10.0;0.6;4288;2848;12212224;4659215;11825;4659215;323767;311942;4671040;199
ISIC_0003657;350;2;3;1.0;0.6;3024;2016;6096384;1646798;2927;1646798;340261;337334;1649725;388
ISIC_0014712;400;2;2;0.01;0.6;6621;4422;29278062;1033916;17328741;1033916;24292916;6964175;18362657;441
ISIC_0007332;300;3;1;10.0;0.6;3024;2016;6096384;5088140;0;5088140;530766;530766;5088140;334
ISIC_0013188;50;2;3;0.1;0.6;3008;2000;6016000;5401223;0;5401223;92544;92544;5401223;27
ISIC_0014712;150;1;2;0.1;0.6;6621;4422;29278062;1953020;14257437;1953020;24292916;10035479;16210457;127
ISIC_0012547;50;2;3;0.1;0.6;4288;2848;12212224;0;572681;0;572681;0;572681;27
ISIC_0008524;100;4;1;100.0;0.6;4288;2848;12212224;5000240;4772;5000240;323767;318995;5005012;110
ISIC_0013082;350;3;1;1.0;0.6;3872;2592;10036224;1953755;0;1953755;254836;254836;1953755;393
ISIC_0008524;200;4;3;10.0;0.6;4288;2848;12212224;3962511;11825;3962511;323767;311942;3974336;239
ISIC_0007332;200;3;3;0.01;0.6;3024;2016;6096384;5169312;0;5169312;530766;530766;5169312;221
ISIC_0013128;300;2;3;100.0;0.6;3872;2592;10036224;5142315;39;5142315;470897;470858;5142354;330
ISIC_0014623;150;2;3;0.01;0.6;2592;1936;5018112;1641821;605412;1641821;1937167;1331755;2247233;146
ISIC_0014623;400;4;2;100.0;0.6;2592;1936;5018112;976474;1143080;976474;1937167;794087;2119554;475
ISIC_0013082;150;4;3;0.01;0.6;3872;2592;10036224;2291610;6512;2291610;254836;248324;2298122;176
ISIC_0012547;250;4;3;10.0;0.6;4288;2848;12212224;11494346;0;11494346;572681;572681;11494346;299
ISIC_0003657;400;2;3;0.01;0.6;3024;2016;6096384;1596767;7551;1596767;340261;332710;1604318;446
ISIC_0014623;250;3;2;10.0;0.6;2592;1936;5018112;1187976;1026846;1187976;1937167;910321;2214822;279
ISIC_0013082;200;2;2;0.1;0.6;3872;2592;10036224;2038278;1543;2038278;254836;253293;2039821;202
ISIC_0003657;300;2;2;100.0;0.6;3024;2016;6096384;1706574;2337;1706574;340261;337924;1708911;325
ISIC_0008524;50;2;3;0.1;0.6;4288;2848;12212224;7151470;0;7151470;323767;323767;7151470;27
ISIC_0014623;400;4;3;0.01;0.6;2592;1936;5018112;941951;1221464;941951;1937167;715703;2163415;476
ISIC_0008524;200;1;3;100.0;0.6;4288;2848;12212224;4726483;11825;4726483;323767;311942;4738308;195
ISIC_0003657;450;3;3;10.0;0.6;3024;2016;6096384;1411783;1807;1411783;340261;338454;1413590;524
ISIC_0007332;300;4;2;10.0;0.6;3024;2016;6096384;5067549;0;5067549;530766;530766;5067549;354
ISIC_0003657;150;2;2;10.0;0.6;3024;2016;6096384;2215745;1986;2215745;340261;338275;2217731;144
ISIC_0014428;300;3;2;100.0;0.6;4288;2848;12212224;1211474;1843;1211474;525860;524017;1213317;340
ISIC_0008524;450;3;2;1.0;0.6;4288;2848;12212224;3671149;14412;3671149;323767;309355;3685561;518
ISIC_0013082;100;3;2;10.0;0.6;3872;2592;10036224;2998470;0;2998470;254836;254836;2998470;99
ISIC_0003657;350;1;3;0.1;0.6;3024;2016;6096384;1859756;0;1859756;340261;340261;1859756;372
ISIC_0014623;400;1;1;0.01;0.6;2592;1936;5018112;1133490;949918;1133490;1937167;987249;2083408;421
ISIC_0008524;150;2;3;10.0;0.6;4288;2848;12212224;4993804;5649;4993804;323767;318118;4999453;149
ISIC_0014623;200;1;2;10.0;0.6;2592;1936;5018112;1415860;743785;1415860;1937167;1193382;2159645;189
ISIC_0013082;250;1;2;0.01;0.6;3872;2592;10036224;2022627;6489;2022627;254836;248347;2029116;246
ISIC_0007332;450;1;1;1.0;0.6;3024;2016;6096384;4697279;83;4697279;530766;530683;4697362;483
ISIC_0013128;200;1;3;0.1;0.6;3872;2592;10036224;5749694;0;5749694;470897;470897;5749694;192
ISIC_0013188;300;2;3;1.0;0.6;3008;2000;6016000;3716146;35;3716146;92544;92509;3716181;328
ISIC_0013082;50;1;2;0.1;0.6;3872;2592;10036224;3654325;2479;3654325;254836;252357;3656804;7
ISIC_0003657;450;4;3;0.1;0.6;3024;2016;6096384;1471912;0;1471912;340261;340261;1471912;537
ISIC_0013128;50;4;1;10.0;0.6;3872;2592;10036224;6779126;0;6779126;470897;470897;6779126;49
ISIC_0013082;100;3;2;1.0;0.6;3872;2592;10036224;2998069;0;2998069;254836;254836;2998069;98
ISIC_0013188;300;2;2;100.0;0.6;3008;2000;6016000;3696080;45;3696080;92544;92499;3696125;325
ISIC_0014712;200;4;3;10.0;0.6;6621;4422;29278062;1245326;17361308;1245326;24292916;6931608;18606634;239
ISIC_0013128;200;4;1;100.0;0.6;3872;2592;10036224;5464858;0;5464858;470897;470897;5464858;230
ISIC_0003657;350;4;2;10.0;0.6;3024;2016;6096384;1523852;2927;1523852;340261;337334;1526779;414
ISIC_0013188;50;2;3;100.0;0.6;3008;2000;6016000;5061948;0;5061948;92544;92544;5061948;30
ISIC_0007332;400;1;3;0.01;0.6;3024;2016;6096384;4611821;12843;4611821;530766;517923;4624664;431
ISIC_0013188;250;4;3;10.0;0.6;3008;2000;6016000;3844062;0;3844062;92544;92544;3844062;299
ISIC_0014712;150;2;3;10.0;0.6;6621;4422;29278062;1997847;15165184;1997847;24292916;9127732;17163031;149
ISIC_0007332;250;3;3;0.01;0.6;3024;2016;6096384;5137279;0;5137279;530766;530766;5137279;281
ISIC_0014623;400;2;3;100.0;0.6;2592;1936;5018112;1079242;1079388;1079242;1937167;857779;2158630;450
ISIC_0013188;350;2;2;1.0;0.6;3008;2000;6016000;3526381;0;3526381;92544;92544;3526381;383
ISIC_0008524;200;4;1;1.0;0.6;4288;2848;12212224;4060525;9957;4060525;323767;313810;4070482;228
ISIC_0012547;300;1;3;1.0;0.6;4288;2848;12212224;11387859;0;11387859;572681;572681;11387859;313
ISIC_0014623;400;1;3;0.1;0.6;2592;1936;5018112;1207893;968346;1207893;1937167;968821;2176239;432
ISIC_0008524;350;4;2;1.0;0.6;4288;2848;12212224;3334048;4860;3334048;323767;318907;3338908;413
ISIC_0013082;100;3;3;1.0;0.6;3872;2592;10036224;2998005;0;2998005;254836;254836;2998005;103
ISIC_0013128;450;2;2;1.0;0.6;3872;2592;10036224;4668818;0;4668818;470897;470897;4668818;503
ISIC_0014623;300;4;1;10.0;0.6;2592;1936;5018112;1030369;1128003;1030369;1937167;809164;2158372;349
ISIC_0007332;300;3;1;0.01;0.6;3024;2016;6096384;5018812;0;5018812;530766;530766;5018812;331
ISIC_0013128;250;1;3;0.01;0.6;3872;2592;10036224;5372714;0;5372714;470897;470897;5372714;251
ISIC_0007332;50;4;3;1.0;0.6;3024;2016;6096384;5116915;0;5116915;530766;530766;5116915;58
ISIC_0007332;100;3;3;100.0;0.6;3024;2016;6096384;0;530766;0;530766;0;530766;105
ISIC_0014428;350;3;1;1.0;0.6;4288;2848;12212224;1161711;8345;1161711;525860;517515;1170056;393
ISIC_0014712;100;2;2;0.01;0.6;6621;4422;29278062;3091615;12377628;3091615;24292916;11915288;15469243;81
ISIC_0007332;50;4;2;0.1;0.6;3024;2016;6096384;5234601;0;5234601;530766;530766;5234601;52
ISIC_0008524;450;2;3;10.0;0.6;4288;2848;12212224;3870647;18436;3870647;323767;305331;3889083;509
ISIC_0013128;50;3;3;0.1;0.6;3872;2592;10036224;7166789;0;7166789;470897;470897;7166789;42
ISIC_0013188;150;2;3;0.01;0.6;3008;2000;6016000;4581853;0;4581853;92544;92544;4581853;146
ISIC_0003657;150;4;3;0.01;0.6;3024;2016;6096384;2009446;16172;2009446;340261;324089;2025618;176
ISIC_0007332;200;3;1;0.1;0.6;3024;2016;6096384;5216825;0;5216825;530766;530766;5216825;212
ISIC_0013188;100;2;1;10.0;0.6;3008;2000;6016000;4801205;0;4801205;92544;92544;4801205;79
ISIC_0012547;400;1;3;100.0;0.6;4288;2848;12212224;11250166;0;11250166;572681;572681;11250166;435
ISIC_0014712;300;1;1;100.0;0.6;6621;4422;29278062;1326287;15822066;1326287;24292916;8470850;17148353;305
ISIC_0012547;450;3;1;1.0;0.6;4288;2848;12212224;11198672;108807;11198672;572681;463874;11307479;513
ISIC_0008524;300;3;2;1.0;0.6;4288;2848;12212224;4306666;1273;4306666;323767;322494;4307939;338
ISIC_0008524;300;2;2;1.0;0.6;4288;2848;12212224;4437980;1334;4437980;323767;322433;4439314;323
ISIC_0013082;400;1;3;1.0;0.6;3872;2592;10036224;1812965;0;1812965;254836;254836;1812965;433
ISIC_0003657;350;3;2;0.1;0.6;3024;2016;6096384;1710000;0;1710000;340261;340261;1710000;397
ISIC_0014623;50;3;2;1.0;0.6;2592;1936;5018112;2054568;437062;2054568;1937167;1500105;2491630;38
ISIC_0014428;200;2;2;100.0;0.6;4288;2848;12212224;1500209;999;1500209;525860;524861;1501208;205
ISIC_0012547;200;3;2;100.0;0.6;4288;2848;12212224;11253140;0;11253140;572681;572681;11253140;220
ISIC_0013128;200;2;3;10.0;0.6;3872;2592;10036224;5660986;0;5660986;470897;470897;5660986;209
ISIC_0014428;250;2;2;100.0;0.6;4288;2848;12212224;1366468;4628;1366468;525860;521232;1371096;265
ISIC_0014623;200;1;3;100.0;0.6;2592;1936;5018112;1415914;743780;1415914;1937167;1193387;2159694;195
ISIC_0014428;300;4;1;100.0;0.6;4288;2848;12212224;1211474;1843;1211474;525860;524017;1213317;350
ISIC_0014428;200;2;2;1.0;0.6;4288;2848;12212224;1398944;3139;1398944;525860;522721;1402083;203
ISIC_0003657;250;1;1;0.1;0.6;3024;2016;6096384;2085050;525;2085050;340261;339736;2085575;242
ISIC_0008524;300;3;3;0.01;0.6;4288;2848;12212224;4431748;386;4431748;323767;323381;4432134;341
ISIC_0003657;250;1;1;1.0;0.6;3024;2016;6096384;2033759;332;2033759;340261;339929;2034091;243
ISIC_0003657;450;1;2;0.1;0.6;3024;2016;6096384;1771546;0;1771546;340261;340261;1771546;487
ISIC_0007332;400;1;3;10.0;0.6;3024;2016;6096384;4811754;0;4811754;530766;530766;4811754;434
ISIC_0008524;350;4;3;0.1;0.6;4288;2848;12212224;3398841;150;3398841;323767;323617;3398991;417
ISIC_0014428;400;3;3;10.0;0.6;4288;2848;12212224;1108993;2796;1108993;525860;523064;1111789;464
ISIC_0007332;400;1;2;1.0;0.6;3024;2016;6096384;4811965;0;4811965;530766;530766;4811965;428
ISIC_0007332;100;4;1;10.0;0.6;3024;2016;6096384;0;530766;0;530766;0;530766;109
ISIC_0013188;450;4;3;1.0;0.6;3008;2000;6016000;3152350;336;3152350;92544;92208;3152686;538
ISIC_0014428;450;3;1;10.0;0.6;4288;2848;12212224;1128313;8163;1128313;525860;517697;1136476;514
ISIC_0003657;50;1;2;1.0;0.6;3024;2016;6096384;2982937;33;2982937;340261;340228;2982970;8
ISIC_0014428;350;2;2;1.0;0.6;4288;2848;12212224;1161902;8901;1161902;525860;516959;1170803;383
ISIC_0007332;300;1;1;100.0;0.6;3024;2016;6096384;5109012;0;5109012;530766;530766;5109012;305
ISIC_0013188;100;3;1;10.0;0.6;3008;2000;6016000;4801204;0;4801204;92544;92544;4801204;94
ISIC_0013188;300;1;3;10.0;0.6;3008;2000;6016000;3696166;45;3696166;92544;92499;3696211;314
ISIC_0007332;200;1;2;100.0;0.6;3024;2016;6096384;5168994;0;5168994;530766;530766;5168994;190
ISIC_0013188;100;2;1;0.01;0.6;3008;2000;6016000;4965257;0;4965257;92544;92544;4965257;76
ISIC_0007332;150;2;2;0.1;0.6;3024;2016;6096384;5482428;0;5482428;530766;530766;5482428;142
ISIC_0013188;50;4;3;0.01;0.6;3008;2000;6016000;5535293;0;5535293;92544;92544;5535293;56
ISIC_0014623;300;3;1;1.0;0.6;2592;1936;5018112;1080858;1094721;1080858;1937167;842446;2175579;333
ISIC_0013082;150;2;1;1.0;0.6;3872;2592;10036224;2689948;2189;2689948;254836;252647;2692137;138
ISIC_0013188;400;2;1;0.01;0.6;3008;2000;6016000;3263681;105;3263681;92544;92439;3263786;436
ISIC_0014712;150;1;3;1.0;0.6;6621;4422;29278062;2011432;13809457;2011432;24292916;10483459;15820889;133
ISIC_0003657;50;3;2;0.01;0.6;3024;2016;6096384;3330965;0;3330965;340261;340261;3330965;36
ISIC_0008524;150;2;1;0.01;0.6;4288;2848;12212224;5331794;0;5331794;323767;323767;5331794;136
ISIC_0003657;450;3;1;10.0;0.6;3024;2016;6096384;1411921;1807;1411921;340261;338454;1413728;514
ISIC_0013188;350;1;2;10.0;0.6;3008;2000;6016000;3526836;0;3526836;92544;92544;3526836;369
ISIC_0013128;200;2;2;0.01;0.6;3872;2592;10036224;5798727;0;5798727;470897;470897;5798727;201
ISIC_0013188;350;4;3;10.0;0.6;3008;2000;6016000;3510357;0;3510357;92544;92544;3510357;419
ISIC_0014623;250;1;1;100.0;0.6;2592;1936;5018112;1407334;890824;1407334;1937167;1046343;2298158;245
ISIC_0007332;200;1;3;10.0;0.6;3024;2016;6096384;5168817;0;5168817;530766;530766;5168817;194
ISIC_0008524;250;1;1;100.0;0.6;4288;2848;12212224;4539447;7441;4539447;323767;316326;4546888;245
ISIC_0014623;50;3;1;100.0;0.6;2592;1936;5018112;2054518;436566;2054518;1937167;1500601;2491084;35
ISIC_0013188;100;3;1;100.0;0.6;3008;2000;6016000;4801215;0;4801215;92544;92544;4801215;95
ISIC_0013188;250;1;3;100.0;0.6;3008;2000;6016000;3868088;0;3868088;92544;92544;3868088;255
ISIC_0007332;100;2;2;0.1;0.6;3024;2016;6096384;0;530766;0;530766;0;530766;82
ISIC_0003657;200;3;3;0.01;0.6;3024;2016;6096384;1828144;26221;1828144;340261;314040;1854365;221
ISIC_0014623;100;2;1;1.0;0.6;2592;1936;5018112;1623559;624496;1623559;1937167;1312671;2248055;78
ISIC_0013082;50;1;3;100.0;0.6;3872;2592;10036224;3808844;0;3808844;254836;254836;3808844;15
ISIC_0013082;100;3;1;1.0;0.6;3872;2592;10036224;2998058;0;2998058;254836;254836;2998058;93
ISIC_0008524;350;2;2;10.0;0.6;4288;2848;12212224;3998552;277;3998552;323767;323490;3998829;384
ISIC_0012547;250;2;1;10.0;0.6;4288;2848;12212224;11494346;0;11494346;572681;572681;11494346;259
ISIC_0014712;150;3;3;0.01;0.6;6621;4422;29278062;1883076;15145982;1883076;24292916;9146934;17029058;161
ISIC_0013188;100;4;1;0.01;0.6;3008;2000;6016000;4828488;0;4828488;92544;92544;4828488;106
ISIC_0014428;100;3;3;100.0;0.6;4288;2848;12212224;2512479;534;2512479;525860;525326;2513013;105
ISIC_0014623;100;3;2;1.0;0.6;2592;1936;5018112;1616936;719567;1616936;1937167;1217600;2336503;98
ISIC_0014623;350;2;2;1.0;0.6;2592;1936;5018112;1095876;1040012;1095876;1937167;897155;2135888;383
ISIC_0013128;450;4;1;100.0;0.6;3872;2592;10036224;4437872;0;4437872;470897;470897;4437872;530
ISIC_0003657;300;3;3;0.01;0.6;3024;2016;6096384;1628086;18116;1628086;340261;322145;1646202;341
ISIC_0012547;400;1;1;100.0;0.6;4288;2848;12212224;11250166;0;11250166;572681;572681;11250166;425
ISIC_0013188;100;2;2;100.0;0.6;3008;2000;6016000;4801213;0;4801213;92544;92544;4801213;85
ISIC_0014623;200;1;3;1.0;0.6;2592;1936;5018112;1415505;743160;1415505;1937167;1194007;2158665;193
ISIC_0008524;400;4;2;10.0;0.6;4288;2848;12212224;3131169;13085;3131169;323767;310682;3144254;474
ISIC_0013188;100;1;2;0.01;0.6;3008;2000;6016000;4929972;0;4929972;92544;92544;4929972;66
ISIC_0013188;450;1;1;1.0;0.6;3008;2000;6016000;3165417;682;3165417;92544;91862;3166099;483
ISIC_0012547;250;2;1;0.1;0.6;4288;2848;12212224;11535322;0;11535322;572681;572681;11535322;257
ISIC_0013128;300;4;3;100.0;0.6;3872;2592;10036224;4966195;39;4966195;470897;470858;4966234;360
ISIC_0008524;50;4;3;1.0;0.6;4288;2848;12212224;5478395;13676;5478395;323767;310091;5492071;58
ISIC_0007332;250;1;2;100.0;0.6;3024;2016;6096384;5174623;895;5174623;530766;529871;5175518;250
ISIC_0013188;400;3;3;10.0;0.6;3008;2000;6016000;3249980;0;3249980;92544;92544;3249980;464
ISIC_0007332;200;2;2;100.0;0.6;3024;2016;6096384;5168994;0;5168994;530766;530766;5168994;205
ISIC_0007332;450;2;3;10.0;0.6;3024;2016;6096384;4683750;83;4683750;530766;530683;4683833;509
ISIC_0014623;400;1;1;10.0;0.6;2592;1936;5018112;1185962;966884;1185962;1937167;970283;2152846;424
ISIC_0013082;100;3;1;0.01;0.6;3872;2592;10036224;3526468;0;3526468;254836;254836;3526468;91
ISIC_0014712;200;3;2;10.0;0.6;6621;4422;29278062;1404141;16368491;1404141;24292916;7924425;17772632;219
ISIC_0008524;250;1;3;0.01;0.6;4288;2848;12212224;4714898;11714;4714898;323767;312053;4726612;251
ISIC_0008524;450;2;2;0.01;0.6;4288;2848;12212224;3904543;2824;3904543;323767;320943;3907367;501
ISIC_0007332;200;2;3;100.0;0.6;3024;2016;6096384;5168995;0;5168995;530766;530766;5168995;210
ISIC_0013082;250;4;2;10.0;0.6;3872;2592;10036224;2106429;0;2106429;254836;254836;2106429;294
ISIC_0013188;450;1;1;0.1;0.6;3008;2000;6016000;3141487;0;3141487;92544;92544;3141487;482
ISIC_0007332;400;1;2;0.1;0.6;3024;2016;6096384;4664820;5465;4664820;530766;525301;4670285;427
ISIC_0008524;100;3;1;0.01;0.6;4288;2848;12212224;6086158;1865;6086158;323767;321902;6088023;91
ISIC_0007332;250;3;1;100.0;0.6;3024;2016;6096384;5150273;895;5150273;530766;529871;5151168;275
ISIC_0008524;450;4;1;1.0;0.6;4288;2848;12212224;2777123;21930;2777123;323767;301837;2799053;528
ISIC_0003657;150;3;3;100.0;0.6;3024;2016;6096384;2093624;1986;2093624;340261;338275;2095610;165
ISIC_0007332;150;4;1;1.0;0.6;3024;2016;6096384;5525218;0;5525218;530766;530766;5525218;168
ISIC_0012547;50;3;2;0.1;0.6;4288;2848;12212224;0;572681;0;572681;0;572681;37
ISIC_0013188;350;4;1;0.1;0.6;3008;2000;6016000;3389973;0;3389973;92544;92544;3389973;407
ISIC_0014712;250;1;1;0.01;0.6;6621;4422;29278062;1998303;15353849;1998303;24292916;8939067;17352152;241
ISIC_0003657;100;3;3;0.01;0.6;3024;2016;6096384;2383251;20299;2383251;340261;319962;2403550;101
ISIC_0012547;250;4;1;1.0;0.6;4288;2848;12212224;11493894;0;11493894;572681;572681;11493894;288
ISIC_0012547;300;3;1;0.01;0.6;4288;2848;12212224;11417770;63967;11417770;572681;508714;11481737;331
ISIC_0013188;300;1;2;100.0;0.6;3008;2000;6016000;3696080;45;3696080;92544;92499;3696125;310
ISIC_0007332;300;3;3;10.0;0.6;3024;2016;6096384;5108872;0;5108872;530766;530766;5108872;344
ISIC_0007332;50;3;1;10.0;0.6;3024;2016;6096384;5143055;0;5143055;530766;530766;5143055;34
ISIC_0013128;400;3;2;1.0;0.6;3872;2592;10036224;4634099;0;4634099;470897;470897;4634099;458
ISIC_0013082;50;3;1;0.01;0.6;3872;2592;10036224;3870289;0;3870289;254836;254836;3870289;31
ISIC_0014712;50;4;1;0.01;0.6;6621;4422;29278062;3096875;14232093;3096875;24292916;10060823;17328968;46
ISIC_0013082;50;3;2;10.0;0.6;3872;2592;10036224;3808938;0;3808938;254836;254836;3808938;39
ISIC_0008524;400;2;3;0.01;0.6;4288;2848;12212224;3941190;11142;3941190;323767;312625;3952332;446
ISIC_0012547;300;3;1;100.0;0.6;4288;2848;12212224;11305031;81608;11305031;572681;491073;11386639;335
ISIC_0014623;150;3;1;0.1;0.6;2592;1936;5018112;1319947;874726;1319947;1937167;1062441;2194673;152
ISIC_0008524;250;4;2;0.01;0.6;4288;2848;12212224;3952268;0;3952268;323767;323767;3952268;291
ISIC_0003657;150;2;1;0.01;0.6;3024;2016;6096384;2448122;0;2448122;340261;340261;2448122;136
ISIC_0014623;200;3;2;100.0;0.6;2592;1936;5018112;1235441;918981;1235441;1937167;1018186;2154422;220
ISIC_0014428;450;2;2;100.0;0.6;4288;2848;12212224;1156198;8163;1156198;525860;517697;1164361;505
ISIC_0013128;450;1;1;1.0;0.6;3872;2592;10036224;4786589;0;4786589;470897;470897;4786589;483
ISIC_0013188;200;4;3;1.0;0.6;3008;2000;6016000;4032892;0;4032892;92544;92544;4032892;238
ISIC_0008524;350;2;3;0.1;0.6;4288;2848;12212224;4026303;185;4026303;323767;323582;4026488;387
ISIC_0014712;450;4;1;1.0;0.6;6621;4422;29278062;1058211;19009610;1058211;24292916;5283306;20067821;528
ISIC_0013128;400;4;1;0.01;0.6;3872;2592;10036224;4558694;0;4558694;470897;470897;4558694;466
ISIC_0008524;150;1;3;0.1;0.6;4288;2848;12212224;5436728;0;5436728;323767;323767;5436728;132
ISIC_0013082;100;2;1;10.0;0.6;3872;2592;10036224;2998484;0;2998484;254836;254836;2998484;79
ISIC_0012547;350;3;2;0.1;0.6;4288;2848;12212224;11232122;38963;11232122;572681;533718;11271085;397
ISIC_0007332;50;3;1;0.1;0.6;3024;2016;6096384;5357806;0;5357806;530766;530766;5357806;32
ISIC_0014712;250;2;1;10.0;0.6;6621;4422;29278062;1784643;16829017;1784643;24292916;7463899;18613660;259
ISIC_0014428;300;3;1;1.0;0.6;4288;2848;12212224;1124972;2154;1124972;525860;523706;1127126;333
ISIC_0014712;300;2;1;0.01;0.6;6621;4422;29278062;1331218;17194671;1331218;24292916;7098245;18525889;316
ISIC_0013082;350;3;2;10.0;0.6;3872;2592;10036224;1955525;0;1955525;254836;254836;1955525;399
ISIC_0014712;200;1;1;100.0;0.6;6621;4422;29278062;1419760;14624022;1419760;24292916;9668894;16043782;185
ISIC_0007332;250;3;1;0.1;0.6;3024;2016;6096384;5102624;1190;5102624;530766;529576;5103814;272
ISIC_0014428;200;4;1;0.1;0.6;4288;2848;12212224;1593490;0;1593490;525860;525860;1593490;227
ISIC_0013128;200;2;2;1.0;0.6;3872;2592;10036224;5660901;0;5660901;470897;470897;5660901;203
ISIC_0014428;450;1;2;100.0;0.6;4288;2848;12212224;1237543;8163;1237543;525860;517697;1245706;490
ISIC_0014623;100;2;3;0.1;0.6;2592;1936;5018112;1667164;545864;1667164;1937167;1391303;2213028;87
ISIC_0003657;250;1;2;1.0;0.6;3024;2016;6096384;2033505;397;2033505;340261;339864;2033902;248
ISIC_0008524;150;3;2;10.0;0.6;4288;2848;12212224;4910871;5649;4910871;323767;318118;4916520;159
ISIC_0014712;100;2;2;10.0;0.6;6621;4422;29278062;3327018;12127935;3327018;24292916;12164981;15454953;84
ISIC_0013082;50;2;3;0.1;0.6;3872;2592;10036224;3658490;2125;3658490;254836;252711;3660615;27
ISIC_0007332;400;2;3;0.1;0.6;3024;2016;6096384;4727657;5495;4727657;530766;525271;4733152;447
ISIC_0013082;50;3;3;100.0;0.6;3872;2592;10036224;3808844;0;3808844;254836;254836;3808844;45
ISIC_0013082;100;1;2;0.01;0.6;3872;2592;10036224;3096877;16545;3096877;254836;238291;3113422;66
ISIC_0014623;400;3;2;1.0;0.6;2592;1936;5018112;1009725;1100014;1009725;1937167;837153;2109739;458
ISIC_0013082;250;1;3;0.1;0.6;3872;2592;10036224;1995740;4513;1995740;254836;250323;2000253;252
ISIC_0014712;300;2;3;0.01;0.6;6621;4422;29278062;1343129;17349691;1343129;24292916;6943225;18692820;326
ISIC_0008524;300;1;2;0.01;0.6;4288;2848;12212224;4545178;1;4545178;323767;323766;4545179;306
ISIC_0014712;400;3;1;10.0;0.6;6621;4422;29278062;1239206;17659900;1239206;24292916;6633016;18899106;454
ISIC_0013082;300;3;3;1.0;0.6;3872;2592;10036224;2130916;1433;2130916;254836;253403;2132349;343
ISIC_0007332;450;3;1;1.0;0.6;3024;2016;6096384;4683681;83;4683681;530766;530683;4683764;513
ISIC_0014428;50;3;2;1.0;0.6;4288;2848;12212224;3157266;1599;3157266;525860;524261;3158865;38
ISIC_0013188;50;4;3;1.0;0.6;3008;2000;6016000;4946714;0;4946714;92544;92544;4946714;58
ISIC_0013128;400;4;2;1.0;0.6;3872;2592;10036224;4482899;0;4482899;470897;470897;4482899;473
ISIC_0003657;300;1;3;0.1;0.6;3024;2016;6096384;1975390;0;1975390;340261;340261;1975390;312
ISIC_0003657;100;2;1;1.0;0.6;3024;2016;6096384;2566751;351;2566751;340261;339910;2567102;78
ISIC_0013188;400;1;3;10.0;0.6;3008;2000;6016000;3265109;0;3265109;92544;92544;3265109;434
ISIC_0013128;400;1;2;0.1;0.6;3872;2592;10036224;4757388;0;4757388;470897;470897;4757388;427
ISIC_0013082;50;3;1;1.0;0.6;3872;2592;10036224;3805774;0;3805774;254836;254836;3805774;33
ISIC_0014428;300;1;2;1.0;0.6;4288;2848;12212224;1251210;2270;1251210;525860;523590;1253480;308
ISIC_0013082;250;1;2;10.0;0.6;3872;2592;10036224;2106429;0;2106429;254836;254836;2106429;249
ISIC_0014623;450;1;3;100.0;0.6;2592;1936;5018112;1111300;1023043;1111300;1937167;914124;2134343;495
ISIC_0014712;450;1;3;0.1;0.6;6621;4422;29278062;1018973;17438482;1018973;24292916;6854434;18457455;492
ISIC_0014712;450;4;1;0.1;0.6;6621;4422;29278062;950058;19211843;950058;24292916;5081073;20161901;527
ISIC_0012547;450;1;2;0.01;0.6;4288;2848;12212224;11348975;40411;11348975;572681;532270;11389386;486
ISIC_0013128;450;3;1;100.0;0.6;3872;2592;10036224;4620848;0;4620848;470897;470897;4620848;515
ISIC_0013188;400;2;1;0.1;0.6;3008;2000;6016000;3131794;0;3131794;92544;92544;3131794;437
ISIC_0013188;200;3;3;0.01;0.6;3008;2000;6016000;4154135;0;4154135;92544;92544;4154135;221
ISIC_0012547;350;3;3;10.0;0.6;4288;2848;12212224;11254071;71369;11254071;572681;501312;11325440;404
ISIC_0014428;300;2;3;0.1;0.6;4288;2848;12212224;1201590;1139;1201590;525860;524721;1202729;327
ISIC_0013188;200;3;1;10.0;0.6;3008;2000;6016000;4007583;0;4007583;92544;92544;4007583;214
ISIC_0003657;300;2;1;1.0;0.6;3024;2016;6096384;1707185;2542;1707185;340261;337719;1709727;318
ISIC_0014623;150;1;1;0.01;0.6;2592;1936;5018112;1789357;567335;1789357;1937167;1369832;2356692;121
ISIC_0007332;400;4;3;0.1;0.6;3024;2016;6096384;4671143;0;4671143;530766;530766;4671143;477
ISIC_0003657;300;4;2;0.01;0.6;3024;2016;6096384;1610429;16618;1610429;340261;323643;1627047;351
ISIC_0012547;400;4;1;100.0;0.6;4288;2848;12212224;11164643;122500;11164643;572681;450181;11287143;470
ISIC_0013188;400;3;1;0.01;0.6;3008;2000;6016000;3271961;90;3271961;92544;92454;3272051;451
ISIC_0012547;400;4;1;1.0;0.6;4288;2848;12212224;11135583;122500;11135583;572681;450181;11258083;468
ISIC_0014712;250;2;1;1.0;0.6;6621;4422;29278062;1784636;16827822;1784636;24292916;7465094;18612458;258
ISIC_0013188;350;3;3;100.0;0.6;3008;2000;6016000;3509965;0;3509965;92544;92544;3509965;405
ISIC_0012547;200;1;3;10.0;0.6;4288;2848;12212224;11253395;0;11253395;572681;572681;11253395;194
ISIC_0013082;300;4;1;100.0;0.6;3872;2592;10036224;2200671;224;2200671;254836;254612;2200895;350
ISIC_0014428;350;1;2;100.0;0.6;4288;2848;12212224;1338154;6259;1338154;525860;519601;1344413;370
ISIC_0013188;200;2;2;0.1;0.6;3008;2000;6016000;4037129;0;4037129;92544;92544;4037129;202
ISIC_0007332;300;3;2;0.01;0.6;3024;2016;6096384;4992397;0;4992397;530766;530766;4992397;336
ISIC_0013128;100;1;1;0.01;0.6;3872;2592;10036224;6884878;0;6884878;470897;470897;6884878;61
ISIC_0013128;250;1;2;1.0;0.6;3872;2592;10036224;5441485;0;5441485;470897;470897;5441485;248
ISIC_0014428;250;2;3;0.1;0.6;4288;2848;12212224;1306539;0;1306539;525860;525860;1306539;267
ISIC_0014623;450;1;3;10.0;0.6;2592;1936;5018112;1111310;1023045;1111310;1937167;914122;2134355;494
ISIC_0012547;350;1;1;10.0;0.6;4288;2848;12212224;11289043;36400;11289043;572681;536281;11325443;364
ISIC_0014712;100;1;1;10.0;0.6;6621;4422;29278062;3652299;10960583;3652299;24292916;13332333;14612882;64
ISIC_0014712;150;4;3;1.0;0.6;6621;4422;29278062;1800792;16333470;1800792;24292916;7959446;18134262;178
ISIC_0003657;150;4;2;10.0;0.6;3024;2016;6096384;1972508;1986;1972508;340261;338275;1974494;174
ISIC_0013128;250;3;2;1.0;0.6;3872;2592;10036224;5441635;0;5441635;470897;470897;5441635;278
ISIC_0014712;100;4;2;100.0;0.6;6621;4422;29278062;3327050;14542522;3327050;24292916;9750394;17869572;115
ISIC_0013188;400;1;3;0.01;0.6;3008;2000;6016000;3142914;1004;3142914;92544;91540;3143918;431
ISIC_0013082;250;1;1;0.1;0.6;3872;2592;10036224;1917236;3734;1917236;254836;251102;1920970;242
ISIC_0012547;50;2;1;0.1;0.6;4288;2848;12212224;0;572681;0;572681;0;572681;17
ISIC_0012547;400;3;3;0.1;0.6;4288;2848;12212224;11263152;64221;11263152;572681;508460;11327373;462
ISIC_0013128;200;3;1;1.0;0.6;3872;2592;10036224;5570143;0;5570143;470897;470897;5570143;213
ISIC_0012547;400;4;3;0.1;0.6;4288;2848;12212224;11233351;91243;11233351;572681;481438;11324594;477
ISIC_0012547;300;4;2;100.0;0.6;4288;2848;12212224;11305047;163216;11305047;572681;409465;11468263;355
ISIC_0013188;250;1;2;100.0;0.6;3008;2000;6016000;3844208;0;3844208;92544;92544;3844208;250
ISIC_0008524;250;2;2;0.1;0.6;4288;2848;12212224;4567093;6132;4567093;323767;317635;4573225;262
ISIC_0013188;350;4;1;0.01;0.6;3008;2000;6016000;3501638;0;3501638;92544;92544;3501638;406
ISIC_0014712;200;4;2;0.1;0.6;6621;4422;29278062;1344957;17790627;1344957;24292916;6502289;19135584;232
ISIC_0008524;300;1;1;100.0;0.6;4288;2848;12212224;4439411;4070;4439411;323767;319697;4443481;305
ISIC_0013128;300;2;3;10.0;0.6;3872;2592;10036224;5142315;39;5142315;470897;470858;5142354;329
ISIC_0003657;100;2;2;1.0;0.6;3024;2016;6096384;2566693;349;2566693;340261;339912;2567042;83
ISIC_0014623;100;2;2;0.01;0.6;2592;1936;5018112;1679154;639561;1679154;1937167;1297606;2318715;81
ISIC_0008524;150;4;1;1.0;0.6;4288;2848;12212224;4319626;1924;4319626;323767;321843;4321550;168
ISIC_0003657;450;4;1;0.1;0.6;3024;2016;6096384;1461296;0;1461296;340261;340261;1461296;527
ISIC_0014623;50;3;2;100.0;0.6;2592;1936;5018112;2054520;436552;2054520;1937167;1500615;2491072;40
ISIC_0003657;100;2;2;10.0;0.6;3024;2016;6096384;2565467;30;2565467;340261;340231;2565497;84
ISIC_0013128;350;3;3;0.1;0.6;3872;2592;10036224;4882941;0;4882941;470897;470897;4882941;402
ISIC_0008524;400;4;1;100.0;0.6;4288;2848;12212224;3131038;13085;3131038;323767;310682;3144123;470
ISIC_0014712;250;3;1;1.0;0.6;6621;4422;29278062;1784636;17065223;1784636;24292916;7227693;18849859;273
ISIC_0003657;300;1;1;1.0;0.6;3024;2016;6096384;1919866;2930;1919866;340261;337331;1922796;303
ISIC_0014428;100;3;2;0.01;0.6;4288;2848;12212224;2502533;0;2502533;525860;525860;2502533;96
ISIC_0014623;100;1;1;10.0;0.6;2592;1936;5018112;1678080;581073;1678080;1937167;1356094;2259153;64
ISIC_0012547;400;4;3;0.01;0.6;4288;2848;12212224;11264872;113210;11264872;572681;459471;11378082;476
ISIC_0014623;200;4;2;1.0;0.6;2592;1936;5018112;1160784;976777;1160784;1937167;960390;2137561;233
ISIC_0012547;150;2;2;100.0;0.6;4288;2848;12212224;11558318;0;11558318;572681;572681;11558318;145
ISIC_0014712;50;3;2;0.01;0.6;6621;4422;29278062;3293793;11199211;3293793;24292916;13093705;14493004;36
ISIC_0014623;50;4;2;0.01;0.6;2592;1936;5018112;2252557;397212;2252557;1937167;1539955;2649769;51
ISIC_0014623;100;3;1;0.1;0.6;2592;1936;5018112;1651553;703134;1651553;1937167;1234033;2354687;92
ISIC_0007332;450;4;3;10.0;0.6;3024;2016;6096384;4640900;83;4640900;530766;530683;4640983;539
ISIC_0014712;350;1;1;0.1;0.6;6621;4422;29278062;1139371;15997391;1139371;24292916;8295525;17136762;362
ISIC_0007332;300;2;2;0.1;0.6;3024;2016;6096384;5022495;0;5022495;530766;530766;5022495;322
ISIC_0007332;200;2;3;0.1;0.6;3024;2016;6096384;5211776;0;5211776;530766;530766;5211776;207
ISIC_0013128;400;3;3;0.01;0.6;3872;2592;10036224;4600415;0;4600415;470897;470897;4600415;461
ISIC_0014428;150;4;1;100.0;0.6;4288;2848;12212224;1828088;990;1828088;525860;524870;1829078;170
ISIC_0014712;300;4;3;1.0;0.6;6621;4422;29278062;1314378;18364379;1314378;24292916;5928537;19678757;358
ISIC_0014712;100;2;1;100.0;0.6;6621;4422;29278062;3327017;12128299;3327017;24292916;12164617;15455316;80
ISIC_0007332;100;2;1;10.0;0.6;3024;2016;6096384;0;530766;0;530766;0;530766;79
ISIC_0014428;450;4;3;0.01;0.6;4288;2848;12212224;726538;20010;726538;525860;505850;746548;536
ISIC_0013128;150;2;3;10.0;0.6;3872;2592;10036224;5812718;0;5812718;470897;470897;5812718;149
ISIC_0013188;200;1;2;0.01;0.6;3008;2000;6016000;4208119;0;4208119;92544;92544;4208119;186
ISIC_0013128;250;2;1;0.1;0.6;3872;2592;10036224;5342067;0;5342067;470897;470897;5342067;257
ISIC_0008524;250;1;2;0.01;0.6;4288;2848;12212224;4786624;0;4786624;323767;323767;4786624;246
ISIC_0013188;100;4;3;100.0;0.6;3008;2000;6016000;4739054;0;4739054;92544;92544;4739054;120
ISIC_0014428;200;3;2;0.1;0.6;4288;2848;12212224;1584248;0;1584248;525860;525860;1584248;217
ISIC_0007332;350;2;3;1.0;0.6;3024;2016;6096384;4872035;0;4872035;530766;530766;4872035;388
ISIC_0013128;350;4;3;100.0;0.6;3872;2592;10036224;4753820;0;4753820;470897;470897;4753820;420
ISIC_0012547;100;2;1;0.01;0.6;4288;2848;12212224;0;572681;0;572681;0;572681;76
ISIC_0013188;200;3;1;0.1;0.6;3008;2000;6016000;4008629;0;4008629;92544;92544;4008629;212
ISIC_0014712;150;2;2;0.01;0.6;6621;4422;29278062;1886052;14377116;1886052;24292916;9915800;16263168;141
ISIC_0013082;150;2;2;100.0;0.6;3872;2592;10036224;2759697;183;2759697;254836;254653;2759880;145
ISIC_0013082;350;2;3;0.01;0.6;3872;2592;10036224;1409279;19312;1409279;254836;235524;1428591;386
ISIC_0003657;50;1;3;1.0;0.6;3024;2016;6096384;2982897;32;2982897;340261;340229;2982929;13
ISIC_0007332;100;2;2;1.0;0.6;3024;2016;6096384;0;530766;0;530766;0;530766;83
ISIC_0008524;450;3;2;10.0;0.6;4288;2848;12212224;3650397;18436;3650397;323767;305331;3668833;519
ISIC_0008524;200;2;3;0.1;0.6;4288;2848;12212224;4906151;3236;4906151;323767;320531;4909387;207
ISIC_0014623;150;4;1;1.0;0.6;2592;1936;5018112;1308466;917833;1308466;1937167;1019334;2226299;168
ISIC_0012547;200;4;3;0.01;0.6;4288;2848;12212224;11557469;0;11557469;572681;572681;11557469;236
ISIC_0013128;400;2;1;0.01;0.6;3872;2592;10036224;4884453;0;4884453;470897;470897;4884453;436
ISIC_0007332;50;2;1;10.0;0.6;3024;2016;6096384;5143055;0;5143055;530766;530766;5143055;19
ISIC_0013188;200;3;2;0.1;0.6;3008;2000;6016000;4058679;0;4058679;92544;92544;4058679;217
ISIC_0008524;250;4;3;1.0;0.6;4288;2848;12212224;3692092;9409;3692092;323767;314358;3701501;298
ISIC_0003657;50;4;2;1.0;0.6;3024;2016;6096384;2177304;56;2177304;340261;340205;2177360;53
ISIC_0013188;50;3;3;0.01;0.6;3008;2000;6016000;5521750;0;5521750;92544;92544;5521750;41
ISIC_0014428;100;2;3;1.0;0.6;4288;2848;12212224;2508706;8526;2508706;525860;517334;2517232;88
ISIC_0014428;450;1;2;0.01;0.6;4288;2848;12212224;1028532;396;1028532;525860;525464;1028928;486
ISIC_0014428;100;3;1;10.0;0.6;4288;2848;12212224;2512700;534;2512700;525860;525326;2513234;94
ISIC_0013082;50;3;3;1.0;0.6;3872;2592;10036224;3805779;0;3805779;254836;254836;3805779;43
ISIC_0014623;300;1;1;100.0;0.6;2592;1936;5018112;1226244;956160;1226244;1937167;981007;2182404;305
ISIC_0013128;450;3;2;100.0;0.6;3872;2592;10036224;4620860;0;4620860;470897;470897;4620860;520
ISIC_0007332;150;2;2;100.0;0.6;3024;2016;6096384;5525218;0;5525218;530766;530766;5525218;145
ISIC_0007332;200;4;3;0.01;0.6;3024;2016;6096384;5194666;0;5194666;530766;530766;5194666;236
ISIC_0013128;450;1;3;1.0;0.6;3872;2592;10036224;4786536;0;4786536;470897;470897;4786536;493
ISIC_0013082;150;2;3;1.0;0.6;3872;2592;10036224;2689919;2176;2689919;254836;252660;2692095;148
ISIC_0014428;450;3;3;0.1;0.6;4288;2848;12212224;786617;3459;786617;525860;522401;790076;522
ISIC_0008524;150;2;3;0.01;0.6;4288;2848;12212224;5347365;0;5347365;323767;323767;5347365;146
ISIC_0014623;150;4;3;0.01;0.6;2592;1936;5018112;1390962;871112;1390962;1937167;1066055;2262074;176
ISIC_0013128;250;2;3;100.0;0.6;3872;2592;10036224;5441792;0;5441792;470897;470897;5441792;270
ISIC_0013188;350;1;1;1.0;0.6;3008;2000;6016000;3507538;0;3507538;92544;92544;3507538;363
ISIC_0014712;100;2;3;1.0;0.6;6621;4422;29278062;3327284;12127243;3327284;24292916;12165673;15454527;88
ISIC_0013128;150;1;2;0.01;0.6;3872;2592;10036224;6458393;0;6458393;470897;470897;6458393;126
ISIC_0014623;250;1;3;100.0;0.6;2592;1936;5018112;1407478;890684;1407478;1937167;1046483;2298162;255
ISIC_0013128;350;4;3;0.1;0.6;3872;2592;10036224;4791136;0;4791136;470897;470897;4791136;417
ISIC_0013128;100;2;3;1.0;0.6;3872;2592;10036224;6775507;0;6775507;470897;470897;6775507;88
ISIC_0012547;450;1;1;10.0;0.6;4288;2848;12212224;11281493;0;11281493;572681;572681;11281493;484
ISIC_0014712;350;4;2;1.0;0.6;6621;4422;29278062;1244920;18095299;1244920;24292916;6197617;19340219;413
ISIC_0003657;400;2;1;0.01;0.6;3024;2016;6096384;1728241;102;1728241;340261;340159;1728343;436
ISIC_0013188;150;2;1;1.0;0.6;3008;2000;6016000;4436894;0;4436894;92544;92544;4436894;138
ISIC_0014428;350;3;2;0.1;0.6;4288;2848;12212224;1071947;0;1071947;525860;525860;1071947;397
ISIC_0012547;400;1;2;0.1;0.6;4288;2848;12212224;11323122;0;11323122;572681;572681;11323122;427
ISIC_0013082;150;3;1;0.1;0.6;3872;2592;10036224;2473262;6467;2473262;254836;248369;2479729;152
ISIC_0007332;400;1;3;100.0;0.6;3024;2016;6096384;4811754;0;4811754;530766;530766;4811754;435
ISIC_0014712;50;3;1;100.0;0.6;6621;4422;29278062;2464669;12862513;2464669;24292916;11430403;15327182;35
ISIC_0012547;350;4;1;0.01;0.6;4288;2848;12212224;11369121;142654;11369121;572681;430027;11511775;406
ISIC_0003657;300;3;1;1.0;0.6;3024;2016;6096384;1582285;2490;1582285;340261;337771;1584775;333
ISIC_0014712;350;4;3;100.0;0.6;6621;4422;29278062;1245619;18095213;1245619;24292916;6197703;19340832;420
ISIC_0013082;150;3;2;1.0;0.6;3872;2592;10036224;2689775;2340;2689775;254836;252496;2692115;158
ISIC_0007332;350;1;3;100.0;0.6;3024;2016;6096384;4871965;0;4871965;530766;530766;4871965;375
ISIC_0014428;350;1;3;0.1;0.6;4288;2848;12212224;1085126;0;1085126;525860;525860;1085126;372
ISIC_0014712;200;2;2;0.1;0.6;6621;4422;29278062;1507925;16650180;1507925;24292916;7642736;18158105;202
ISIC_0007332;100;2;3;100.0;0.6;3024;2016;6096384;0;530766;0;530766;0;530766;90
ISIC_0013128;200;4;3;0.1;0.6;3872;2592;10036224;5559794;0;5559794;470897;470897;5559794;237
ISIC_0007332;50;3;3;100.0;0.6;3024;2016;6096384;5150117;0;5150117;530766;530766;5150117;45
ISIC_0014428;200;4;2;1.0;0.6;4288;2848;12212224;1337637;3340;1337637;525860;522520;1340977;233
ISIC_0012547;100;3;1;1.0;0.6;4288;2848;12212224;0;572681;0;572681;0;572681;93
ISIC_0013082;400;1;1;1.0;0.6;3872;2592;10036224;1787466;0;1787466;254836;254836;1787466;423
ISIC_0014623;450;4;1;0.01;0.6;2592;1936;5018112;923301;1200936;923301;1937167;736231;2124237;526
ISIC_0014428;50;4;3;10.0;0.6;4288;2848;12212224;2715589;1211;2715589;525860;524649;2716800;59
ISIC_0003657;300;2;3;1.0;0.6;3024;2016;6096384;1707257;2507;1707257;340261;337754;1709764;328
ISIC_0007332;400;2;2;0.1;0.6;3024;2016;6096384;4664886;5385;4664886;530766;525381;4670271;442
ISIC_0013082;300;3;2;0.1;0.6;3872;2592;10036224;1949499;7739;1949499;254836;247097;1957238;337
ISIC_0008524;200;3;1;0.1;0.6;4288;2848;12212224;4720358;3100;4720358;323767;320667;4723458;212
ISIC_0014428;450;4;1;0.1;0.6;4288;2848;12212224;863467;2616;863467;525860;523244;866083;527
ISIC_0013188;200;2;1;1.0;0.6;3008;2000;6016000;4059020;0;4059020;92544;92544;4059020;198
ISIC_0012547;200;4;3;100.0;0.6;4288;2848;12212224;11252493;61009;11252493;572681;511672;11313502;240
ISIC_0008524;50;3;1;0.01;0.6;4288;2848;12212224;7287825;0;7287825;323767;323767;7287825;31
ISIC_0014428;50;2;1;0.01;0.6;4288;2848;12212224;3612952;0;3612952;525860;525860;3612952;16
ISIC_0013082;200;4;1;10.0;0.6;3872;2592;10036224;2123893;200;2123893;254836;254636;2124093;229
ISIC_0014428;150;3;1;0.1;0.6;4288;2848;12212224;1574601;39;1574601;525860;525821;1574640;152
ISIC_0014623;50;2;1;0.01;0.6;2592;1936;5018112;2240995;398445;2240995;1937167;1538722;2639440;16
ISIC_0014428;50;2;2;100.0;0.6;4288;2848;12212224;2715313;1211;2715313;525860;524649;2716524;25
ISIC_0014428;150;2;3;0.01;0.6;4288;2848;12212224;1762748;16558;1762748;525860;509302;1779306;146
ISIC_0014712;250;3;2;10.0;0.6;6621;4422;29278062;1784886;17066002;1784886;24292916;7226914;18850888;279
ISIC_0003657;100;2;2;0.01;0.6;3024;2016;6096384;2582720;18025;2582720;340261;322236;2600745;81
ISIC_0014623;250;4;2;0.1;0.6;2592;1936;5018112;1105018;1084694;1105018;1937167;852473;2189712;292
ISIC_0013128;50;1;2;100.0;0.6;3872;2592;10036224;6971240;0;6971240;470897;470897;6971240;10
ISIC_0014428;350;2;2;10.0;0.6;4288;2848;12212224;1232873;6259;1232873;525860;519601;1239132;384
ISIC_0014428;200;4;3;1.0;0.6;4288;2848;12212224;1337820;3334;1337820;525860;522526;1341154;238
ISIC_0003657;150;4;3;10.0;0.6;3024;2016;6096384;1972508;1986;1972508;340261;338275;1974494;179
ISIC_0013128;400;3;1;0.01;0.6;3872;2592;10036224;4736967;0;4736967;470897;470897;4736967;451
ISIC_0013188;150;2;1;0.01;0.6;3008;2000;6016000;4586163;0;4586163;92544;92544;4586163;136
ISIC_0013128;150;1;3;0.1;0.6;3872;2592;10036224;5929018;0;5929018;470897;470897;5929018;132
ISIC_0008524;400;1;1;1.0;0.6;4288;2848;12212224;4150043;3751;4150043;323767;320016;4153794;423
ISIC_0012547;200;2;2;1.0;0.6;4288;2848;12212224;11261086;0;11261086;572681;572681;11261086;203
ISIC_0014623;200;1;1;10.0;0.6;2592;1936;5018112;1416049;743803;1416049;1937167;1193364;2159852;184
ISIC_0013082;150;2;1;0.1;0.6;3872;2592;10036224;2491943;0;2491943;254836;254836;2491943;137
ISIC_0014712;100;4;1;100.0;0.6;6621;4422;29278062;3327035;14542538;3327035;24292916;9750378;17869573;110
ISIC_0014712;400;3;2;0.01;0.6;6621;4422;29278062;1031683;17521082;1031683;24292916;6771834;18552765;456
ISIC_0014623;200;4;2;100.0;0.6;2592;1936;5018112;1160633;976776;1160633;1937167;960391;2137409;235
ISIC_0003657;150;1;3;100.0;0.6;3024;2016;6096384;2377437;1986;2377437;340261;338275;2379423;135
ISIC_0014623;250;3;1;100.0;0.6;2592;1936;5018112;1187831;1026846;1187831;1937167;910321;2214677;275
ISIC_0007332;250;2;1;100.0;0.6;3024;2016;6096384;5174609;895;5174609;530766;529871;5175504;260
ISIC_0003657;400;2;1;100.0;0.6;3024;2016;6096384;1610027;3890;1610027;340261;336371;1613917;440
ISIC_0007332;150;3;1;0.1;0.6;3024;2016;6096384;5478296;0;5478296;530766;530766;5478296;152
ISIC_0008524;150;4;1;0.01;0.6;4288;2848;12212224;4608964;0;4608964;323767;323767;4608964;166
ISIC_0013082;300;3;1;10.0;0.6;3872;2592;10036224;2200750;224;2200750;254836;254612;2200974;334
ISIC_0014623;200;1;2;0.01;0.6;2592;1936;5018112;1537268;829636;1537268;1937167;1107531;2366904;186
ISIC_0008524;350;2;1;1.0;0.6;4288;2848;12212224;4000856;4611;4000856;323767;319156;4005467;378
ISIC_0007332;400;2;1;100.0;0.6;3024;2016;6096384;4811876;0;4811876;530766;530766;4811876;440
ISIC_0007332;150;1;1;0.01;0.6;3024;2016;6096384;5500634;0;5500634;530766;530766;5500634;121
ISIC_0003657;300;1;2;100.0;0.6;3024;2016;6096384;1919065;2337;1919065;340261;337924;1921402;310
ISIC_0013128;150;2;3;100.0;0.6;3872;2592;10036224;5812718;0;5812718;470897;470897;5812718;150
ISIC_0012547;350;1;2;0.01;0.6;4288;2848;12212224;11441898;876;11441898;572681;571805;11442774;366
ISIC_0013188;100;2;2;0.1;0.6;3008;2000;6016000;4860926;0;4860926;92544;92544;4860926;82
ISIC_0013082;100;3;3;10.0;0.6;3872;2592;10036224;2998446;0;2998446;254836;254836;2998446;104
ISIC_0012547;100;3;2;0.01;0.6;4288;2848;12212224;0;572681;0;572681;0;572681;96
ISIC_0013082;250;2;1;10.0;0.6;3872;2592;10036224;2106229;0;2106229;254836;254836;2106229;259
ISIC_0012547;100;3;3;1.0;0.6;4288;2848;12212224;0;572681;0;572681;0;572681;103
ISIC_0003657;400;1;3;0.01;0.6;3024;2016;6096384;1700375;12725;1700375;340261;327536;1713100;431
ISIC_0013082;250;3;2;100.0;0.6;3872;2592;10036224;2106430;0;2106430;254836;254836;2106430;280
ISIC_0003657;200;3;2;0.01;0.6;3024;2016;6096384;1873541;17958;1873541;340261;322303;1891499;216
ISIC_0014428;250;4;3;100.0;0.6;4288;2848;12212224;1317627;4628;1317627;525860;521232;1322255;300
ISIC_0013128;100;1;3;10.0;0.6;3872;2592;10036224;6977563;0;6977563;470897;470897;6977563;74
ISIC_0008524;250;3;1;0.1;0.6;4288;2848;12212224;4359207;6283;4359207;323767;317484;4365490;272
ISIC_0008524;450;4;3;0.01;0.6;4288;2848;12212224;2881448;2935;2881448;323767;320832;2884383;536
ISIC_0008524;200;2;3;100.0;0.6;4288;2848;12212224;4659214;11825;4659214;323767;311942;4671039;210
ISIC_0014428;150;4;3;0.01;0.6;4288;2848;12212224;1609027;16360;1609027;525860;509500;1625387;176
ISIC_0008524;350;4;1;1.0;0.6;4288;2848;12212224;3334067;4919;3334067;323767;318848;3338986;408
ISIC_0014712;100;3;1;1.0;0.6;6621;4422;29278062;3327071;12430061;3327071;24292916;11862855;15757132;93
ISIC_0012547;50;2;2;100.0;0.6;4288;2848;12212224;10811912;0;10811912;572681;572681;10811912;25
ISIC_0013082;200;3;2;100.0;0.6;3872;2592;10036224;2123931;200;2123931;254836;254636;2124131;220
ISIC_0014623;250;4;1;100.0;0.6;2592;1936;5018112;1086078;1047197;1086078;1937167;889970;2133275;290
ISIC_0013188;350;2;3;100.0;0.6;3008;2000;6016000;3509965;0;3509965;92544;92544;3509965;390
ISIC_0014623;150;3;2;0.01;0.6;2592;1936;5018112;1349242;809060;1349242;1937167;1128107;2158302;156
ISIC_0014623;150;1;1;1.0;0.6;2592;1936;5018112;1601196;679539;1601196;1937167;1257628;2280735;123
ISIC_0013188;50;3;3;100.0;0.6;3008;2000;6016000;5061948;0;5061948;92544;92544;5061948;45
ISIC_0003657;50;1;2;0.1;0.6;3024;2016;6096384;3860515;533;3860515;340261;339728;3861048;7
ISIC_0007332;150;3;2;1.0;0.6;3024;2016;6096384;5525218;0;5525218;530766;530766;5525218;158
ISIC_0014712;250;3;1;0.1;0.6;6621;4422;29278062;1787555;17159576;1787555;24292916;7133340;18947131;272
ISIC_0003657;100;2;1;0.1;0.6;3024;2016;6096384;2607341;81;2607341;340261;340180;2607422;77
ISIC_0012547;150;4;2;100.0;0.6;4288;2848;12212224;11558318;0;11558318;572681;572681;11558318;175
ISIC_0007332;250;3;2;100.0;0.6;3024;2016;6096384;5150286;895;5150286;530766;529871;5151181;280
ISIC_0008524;100;2;3;0.01;0.6;4288;2848;12212224;5929611;25781;5929611;323767;297986;5955392;86
ISIC_0014428;250;2;3;0.01;0.6;4288;2848;12212224;1169906;17580;1169906;525860;508280;1187486;266
ISIC_0013188;200;1;2;1.0;0.6;3008;2000;6016000;4058603;0;4058603;92544;92544;4058603;188
ISIC_0014623;450;4;3;0.1;0.6;2592;1936;5018112;880789;1218186;880789;1937167;718981;2098975;537
ISIC_0014712;300;3;2;0.01;0.6;6621;4422;29278062;1408748;17399483;1408748;24292916;6893433;18808231;336
ISIC_0014623;400;3;1;10.0;0.6;2592;1936;5018112;1009209;1100070;1009209;1937167;837097;2109279;454
ISIC_0008524;300;1;2;0.1;0.6;4288;2848;12212224;4432685;5450;4432685;323767;318317;4438135;307
ISIC_0014623;150;2;2;10.0;0.6;2592;1936;5018112;1540473;753626;1540473;1937167;1183541;2294099;144
ISIC_0014623;100;3;3;100.0;0.6;2592;1936;5018112;1536427;719447;1536427;1937167;1217720;2255874;105
ISIC_0013188;450;2;3;100.0;0.6;3008;2000;6016000;3126271;0;3126271;92544;92544;3126271;510
ISIC_0013082;200;2;3;10.0;0.6;3872;2592;10036224;2123916;200;2123916;254836;254636;2124116;209
ISIC_0013082;400;2;3;1.0;0.6;3872;2592;10036224;1813684;0;1813684;254836;254836;1813684;448
ISIC_0008524;450;1;3;0.1;0.6;4288;2848;12212224;4051520;9312;4051520;323767;314455;4060832;492
ISIC_0012547;200;1;2;0.01;0.6;4288;2848;12212224;11545952;0;11545952;572681;572681;11545952;186
ISIC_0007332;100;4;2;0.01;0.6;3024;2016;6096384;0;530766;0;530766;0;530766;111
ISIC_0013128;400;2;2;10.0;0.6;3872;2592;10036224;4607544;0;4607544;470897;470897;4607544;444
ISIC_0014623;450;4;2;0.1;0.6;2592;1936;5018112;880438;1218369;880438;1937167;718798;2098807;532
ISIC_0014623;100;3;3;0.1;0.6;2592;1936;5018112;1573694;642170;1573694;1937167;1294997;2215864;102
ISIC_0008524;250;2;3;1.0;0.6;4288;2848;12212224;4540484;9462;4540484;323767;314305;4549946;268
ISIC_0014712;50;1;3;100.0;0.6;6621;4422;29278062;2825601;10386460;2825601;24292916;13906456;13212061;15
ISIC_0013128;300;2;2;0.1;0.6;3872;2592;10036224;5105971;0;5105971;470897;470897;5105971;322
ISIC_0014428;350;2;3;1.0;0.6;4288;2848;12212224;1198179;8844;1198179;525860;517016;1207023;388
ISIC_0003657;150;4;1;100.0;0.6;3024;2016;6096384;1972507;1986;1972507;340261;338275;1974493;170
ISIC_0008524;300;2;3;0.1;0.6;4288;2848;12212224;4367735;11710;4367735;323767;312057;4379445;327
ISIC_0013128;400;3;2;0.01;0.6;3872;2592;10036224;4646050;0;4646050;470897;470897;4646050;456
ISIC_0014712;200;4;2;1.0;0.6;6621;4422;29278062;1355125;17599597;1355125;24292916;6693319;18954722;233
ISIC_0007332;200;3;1;100.0;0.6;3024;2016;6096384;5168785;0;5168785;530766;530766;5168785;215
ISIC_0007332;450;4;3;100.0;0.6;3024;2016;6096384;4640900;83;4640900;530766;530683;4640983;540
ISIC_0014623;100;1;2;0.1;0.6;2592;1936;5018112;1824941;597792;1824941;1937167;1339375;2422733;67
ISIC_0007332;100;3;1;100.0;0.6;3024;2016;6096384;0;530766;0;530766;0;530766;95
ISIC_0008524;400;4;1;10.0;0.6;4288;2848;12212224;3131037;13085;3131037;323767;310682;3144122;469
ISIC_0008524;200;2;3;0.01;0.6;4288;2848;12212224;4865153;0;4865153;323767;323767;4865153;206
ISIC_0014623;350;3;3;100.0;0.6;2592;1936;5018112;1040079;1054531;1040079;1937167;882636;2094610;405
ISIC_0014712;150;4;3;100.0;0.6;6621;4422;29278062;1799378;16333380;1799378;24292916;7959536;18132758;180
ISIC_0003657;50;3;3;100.0;0.6;3024;2016;6096384;2192265;72;2192265;340261;340189;2192337;45
ISIC_0013128;300;2;2;1.0;0.6;3872;2592;10036224;5142558;55;5142558;470897;470842;5142613;323
ISIC_0013082;250;1;2;1.0;0.6;3872;2592;10036224;2105951;0;2105951;254836;254836;2105951;248
ISIC_0007332;200;3;2;0.01;0.6;3024;2016;6096384;5095293;0;5095293;530766;530766;5095293;216
ISIC_0012547;350;2;1;0.1;0.6;4288;2848;12212224;11229239;0;11229239;572681;572681;11229239;377
ISIC_0014712;250;3;2;0.1;0.6;6621;4422;29278062;1787238;17038065;1787238;24292916;7254851;18825303;277
ISIC_0013082;200;2;3;0.01;0.6;3872;2592;10036224;2246440;12224;2246440;254836;242612;2258664;206
ISIC_0013082;400;1;2;1.0;0.6;3872;2592;10036224;1813010;0;1813010;254836;254836;1813010;428
ISIC_0013188;50;1;2;100.0;0.6;3008;2000;6016000;5061945;0;5061945;92544;92544;5061945;10
ISIC_0013128;100;2;1;0.01;0.6;3872;2592;10036224;6825948;0;6825948;470897;470897;6825948;76
ISIC_0008524;350;4;3;1.0;0.6;4288;2848;12212224;3334124;4781;3334124;323767;318986;3338905;418
ISIC_0008524;300;4;1;0.1;0.6;4288;2848;12212224;3720714;3304;3720714;323767;320463;3724018;347
ISIC_0014623;450;4;1;0.1;0.6;2592;1936;5018112;879766;1218541;879766;1937167;718626;2098307;527
ISIC_0013188;200;2;2;10.0;0.6;3008;2000;6016000;4007592;0;4007592;92544;92544;4007592;204
ISIC_0013188;150;1;2;100.0;0.6;3008;2000;6016000;4477530;0;4477530;92544;92544;4477530;130
ISIC_0014623;100;4;2;1.0;0.6;2592;1936;5018112;1496480;768302;1496480;1937167;1168865;2264782;113
ISIC_0012547;50;1;3;0.1;0.6;4288;2848;12212224;0;572681;0;572681;0;572681;12
ISIC_0014712;150;4;3;0.01;0.6;6621;4422;29278062;1688560;16406806;1688560;24292916;7886110;18095366;176
ISIC_0012547;450;1;3;0.01;0.6;4288;2848;12212224;11227907;41776;11227907;572681;530905;11269683;491
ISIC_0014712;300;2;3;10.0;0.6;6621;4422;29278062;1318803;17086951;1318803;24292916;7205965;18405754;329
ISIC_0014428;450;3;1;1.0;0.6;4288;2848;12212224;1148176;1498;1148176;525860;524362;1149674;513
ISIC_0007332;250;1;3;100.0;0.6;3024;2016;6096384;5174763;895;5174763;530766;529871;5175658;255
ISIC_0007332;50;1;3;100.0;0.6;3024;2016;6096384;5150049;0;5150049;530766;530766;5150049;15
ISIC_0013082;200;1;2;100.0;0.6;3872;2592;10036224;2123930;200;2123930;254836;254636;2124130;190
ISIC_0014712;150;3;1;100.0;0.6;6621;4422;29278062;1997847;15360548;1997847;24292916;8932368;17358395;155
ISIC_0008524;50;3;2;10.0;0.6;4288;2848;12212224;6380744;12096;6380744;323767;311671;6392840;39
ISIC_0014428;450;2;1;10.0;0.6;4288;2848;12212224;1156198;8163;1156198;525860;517697;1164361;499
ISIC_0013188;300;4;2;0.01;0.6;3008;2000;6016000;3669845;0;3669845;92544;92544;3669845;351
ISIC_0007332;450;4;1;10.0;0.6;3024;2016;6096384;4640935;83;4640935;530766;530683;4641018;529
ISIC_0013128;300;4;1;10.0;0.6;3872;2592;10036224;4966378;39;4966378;470897;470858;4966417;349
ISIC_0013188;100;4;3;1.0;0.6;3008;2000;6016000;4738088;0;4738088;92544;92544;4738088;118
ISIC_0013082;150;4;1;100.0;0.6;3872;2592;10036224;2759697;183;2759697;254836;254653;2759880;170
ISIC_0013082;50;2;1;10.0;0.6;3872;2592;10036224;3808920;0;3808920;254836;254836;3808920;19
ISIC_0013188;400;3;2;0.01;0.6;3008;2000;6016000;3209244;210;3209244;92544;92334;3209454;456
ISIC_0012547;150;3;1;1.0;0.6;4288;2848;12212224;11558088;0;11558088;572681;572681;11558088;153
ISIC_0013188;300;4;2;0.1;0.6;3008;2000;6016000;3668365;0;3668365;92544;92544;3668365;352
ISIC_0003657;100;4;2;0.1;0.6;3024;2016;6096384;2469165;85;2469165;340261;340176;2469250;112
ISIC_0014428;400;3;3;0.1;0.6;4288;2848;12212224;941061;10695;941061;525860;515165;951756;462
ISIC_0012547;400;4;2;0.01;0.6;4288;2848;12212224;11292838;114477;11292838;572681;458204;11407315;471
ISIC_0013188;250;2;3;100.0;0.6;3008;2000;6016000;3844063;0;3844063;92544;92544;3844063;270
ISIC_0014712;350;2;3;0.01;0.6;6621;4422;29278062;1037656;17473900;1037656;24292916;6819016;18511556;386
ISIC_0014428;250;3;2;10.0;0.6;4288;2848;12212224;1366468;4628;1366468;525860;521232;1371096;279
ISIC_0008524;400;3;2;1.0;0.6;4288;2848;12212224;3945213;3664;3945213;323767;320103;3948877;458
ISIC_0013128;150;4;3;1.0;0.6;3872;2592;10036224;5678553;0;5678553;470897;470897;5678553;178
ISIC_0014712;150;3;1;0.1;0.6;6621;4422;29278062;1941444;15605453;1941444;24292916;8687463;17546897;152
ISIC_0007332;400;4;3;100.0;0.6;3024;2016;6096384;4766796;0;4766796;530766;530766;4766796;480
ISIC_0013188;250;2;1;1.0;0.6;3008;2000;6016000;3797607;0;3797607;92544;92544;3797607;258
ISIC_0007332;50;3;2;100.0;0.6;3024;2016;6096384;5139558;0;5139558;530766;530766;5139558;40
ISIC_0012547;450;3;1;0.01;0.6;4288;2848;12212224;11315730;69362;11315730;572681;503319;11385092;511
ISIC_0013128;400;2;3;100.0;0.6;3872;2592;10036224;4607542;0;4607542;470897;470897;4607542;450
ISIC_0013082;400;2;3;0.1;0.6;3872;2592;10036224;1681692;0;1681692;254836;254836;1681692;447
ISIC_0013128;200;3;1;0.01;0.6;3872;2592;10036224;5755428;0;5755428;470897;470897;5755428;211
ISIC_0003657;200;1;1;1.0;0.6;3024;2016;6096384;2128495;386;2128495;340261;339875;2128881;183
ISIC_0014712;200;2;3;0.01;0.6;6621;4422;29278062;1648752;16219981;1648752;24292916;8072935;17868733;206
ISIC_0014623;450;2;3;100.0;0.6;2592;1936;5018112;1000657;1111210;1000657;1937167;825957;2111867;510
ISIC_0014623;450;3;1;0.01;0.6;2592;1936;5018112;984605;1149188;984605;1937167;787979;2133793;511
ISIC_0013082;100;2;3;10.0;0.6;3872;2592;10036224;2998448;0;2998448;254836;254836;2998448;89
ISIC_0008524;350;3;3;0.01;0.6;4288;2848;12212224;4060886;4999;4060886;323767;318768;4065885;401
ISIC_0014623;50;4;3;0.01;0.6;2592;1936;5018112;2251246;394043;2251246;1937167;1543124;2645289;56
ISIC_0014428;400;4;2;10.0;0.6;4288;2848;12212224;1078368;2797;1078368;525860;523063;1081165;474
ISIC_0014712;250;3;1;0.01;0.6;6621;4422;29278062;1761719;17101960;1761719;24292916;7190956;18863679;271
ISIC_0013128;350;3;2;0.01;0.6;3872;2592;10036224;4830880;0;4830880;470897;470897;4830880;396
ISIC_0013188;200;4;1;0.01;0.6;3008;2000;6016000;4278513;0;4278513;92544;92544;4278513;226
ISIC_0003657;350;4;2;0.1;0.6;3024;2016;6096384;1605376;0;1605376;340261;340261;1605376;412
ISIC_0014712;400;4;1;1.0;0.6;6621;4422;29278062;1232275;18911359;1232275;24292916;5381557;20143634;468
ISIC_0007332;250;2;1;10.0;0.6;3024;2016;6096384;5174609;895;5174609;530766;529871;5175504;259
ISIC_0014712;250;2;3;10.0;0.6;6621;4422;29278062;1784884;16828997;1784884;24292916;7463919;18613881;269
ISIC_0003657;350;2;1;1.0;0.6;3024;2016;6096384;1628999;2927;1628999;340261;337334;1631926;378
ISIC_0014623;50;4;1;0.1;0.6;2592;1936;5018112;2043006;442149;2043006;1937167;1495018;2485155;47
ISIC_0013188;250;1;2;1.0;0.6;3008;2000;6016000;3822191;0;3822191;92544;92544;3822191;248
ISIC_0014712;450;3;2;0.01;0.6;6621;4422;29278062;1020327;18294672;1020327;24292916;5998244;19314999;516
ISIC_0003657;200;4;1;10.0;0.6;3024;2016;6096384;1662509;1959;1662509;340261;338302;1664468;229
ISIC_0012547;100;1;2;0.1;0.6;4288;2848;12212224;0;572681;0;572681;0;572681;67
ISIC_0014428;250;4;1;0.01;0.6;4288;2848;12212224;1460027;0;1460027;525860;525860;1460027;286
ISIC_0013128;50;4;2;0.1;0.6;3872;2592;10036224;6959430;0;6959430;470897;470897;6959430;52
ISIC_0014623;400;2;1;10.0;0.6;2592;1936;5018112;1079228;1079388;1079228;1937167;857779;2158616;439
ISIC_0008524;300;1;1;1.0;0.6;4288;2848;12212224;4411894;16404;4411894;323767;307363;4428298;303
ISIC_0013188;400;2;1;10.0;0.6;3008;2000;6016000;3250018;0;3250018;92544;92544;3250018;439
ISIC_0007332;100;2;3;0.1;0.6;3024;2016;6096384;0;530766;0;530766;0;530766;87
ISIC_0013082;100;4;2;1.0;0.6;3872;2592;10036224;2998014;0;2998014;254836;254836;2998014;113
ISIC_0003657;300;3;2;0.1;0.6;3024;2016;6096384;1741242;0;1741242;340261;340261;1741242;337
ISIC_0014623;300;4;2;0.1;0.6;2592;1936;5018112;1008005;1129763;1008005;1937167;807404;2137768;352
ISIC_0013128;150;1;3;1.0;0.6;3872;2592;10036224;5945916;0;5945916;470897;470897;5945916;133
ISIC_0014623;300;1;3;1.0;0.6;2592;1936;5018112;1226490;956736;1226490;1937167;980431;2183226;313
ISIC_0013082;100;4;3;0.1;0.6;3872;2592;10036224;2977363;20536;2977363;254836;234300;2997899;117
ISIC_0014712;400;1;1;10.0;0.6;6621;4422;29278062;1404245;16479696;1404245;24292916;7813220;17883941;424
ISIC_0013188;200;4;2;100.0;0.6;3008;2000;6016000;3977595;0;3977595;92544;92544;3977595;235
ISIC_0012547;100;4;3;1.0;0.6;4288;2848;12212224;0;572681;0;572681;0;572681;118
ISIC_0013128;300;1;2;1.0;0.6;3872;2592;10036224;5178931;55;5178931;470897;470842;5178986;308
ISIC_0013082;450;1;2;0.01;0.6;3872;2592;10036224;1573557;6747;1573557;254836;248089;1580304;486
ISIC_0007332;350;1;1;100.0;0.6;3024;2016;6096384;4871959;0;4871959;530766;530766;4871959;365
ISIC_0014623;250;3;3;0.01;0.6;2592;1936;5018112;1217620;946865;1217620;1937167;990302;2164485;281
ISIC_0003657;350;1;1;100.0;0.6;3024;2016;6096384;1804616;2927;1804616;340261;337334;1807543;365
ISIC_0008524;450;2;1;100.0;0.6;4288;2848;12212224;3870647;18436;3870647;323767;305331;3889083;500
ISIC_0003657;150;1;1;100.0;0.6;3024;2016;6096384;2377437;1986;2377437;340261;338275;2379423;125
ISIC_0014428;100;3;1;100.0;0.6;4288;2848;12212224;2512483;534;2512483;525860;525326;2513017;95
ISIC_0014712;450;2;2;1.0;0.6;6621;4422;29278062;1061950;18096379;1061950;24292916;6196537;19158329;503
ISIC_0014623;350;4;1;0.1;0.6;2592;1936;5018112;961101;1147369;961101;1937167;789798;2108470;407
ISIC_0014623;200;4;1;1.0;0.6;2592;1936;5018112;1160759;976782;1160759;1937167;960385;2137541;228
ISIC_0013128;150;2;1;0.01;0.6;3872;2592;10036224;6047626;0;6047626;470897;470897;6047626;136
ISIC_0007332;200;1;3;1.0;0.6;3024;2016;6096384;5165006;0;5165006;530766;530766;5165006;193
ISIC_0014623;100;1;2;10.0;0.6;2592;1936;5018112;1678088;581067;1678088;1937167;1356100;2259155;69
ISIC_0007332;50;4;3;0.01;0.6;3024;2016;6096384;0;530766;0;530766;0;530766;56
ISIC_0003657;200;3;3;1.0;0.6;3024;2016;6096384;1843623;359;1843623;340261;339902;1843982;223
ISIC_0014428;100;3;3;10.0;0.6;4288;2848;12212224;2512692;534;2512692;525860;525326;2513226;104
ISIC_0014712;300;3;1;100.0;0.6;6621;4422;29278062;1314374;17478140;1314374;24292916;6814776;18792514;335
ISIC_0013082;350;2;3;100.0;0.6;3872;2592;10036224;1955510;0;1955510;254836;254836;1955510;390
ISIC_0014623;150;1;3;0.1;0.6;2592;1936;5018112;1658096;768956;1658096;1937167;1168211;2427052;132
ISIC_0014428;150;2;2;10.0;0.6;4288;2848;12212224;2072040;990;2072040;525860;524870;2073030;144
ISIC_0014623;450;4;1;100.0;0.6;2592;1936;5018112;875596;1217578;875596;1937167;719589;2093174;530
ISIC_0014712;150;2;1;10.0;0.6;6621;4422;29278062;1997847;15165184;1997847;24292916;9127732;17163031;139
ISIC_0007332;100;4;1;0.1;0.6;3024;2016;6096384;0;530766;0;530766;0;530766;107
ISIC_0013188;300;1;2;0.1;0.6;3008;2000;6016000;3676908;0;3676908;92544;92544;3676908;307
ISIC_0014712;50;3;2;0.1;0.6;6621;4422;29278062;2458247;13463506;2458247;24292916;10829410;15921753;37
ISIC_0013128;350;3;1;0.1;0.6;3872;2592;10036224;4945469;0;4945469;470897;470897;4945469;392
ISIC_0013082;200;1;1;10.0;0.6;3872;2592;10036224;2123892;200;2123892;254836;254636;2124092;184
ISIC_0007332;200;1;3;100.0;0.6;3024;2016;6096384;5169000;0;5169000;530766;530766;5169000;195
ISIC_0013128;450;1;3;0.01;0.6;3872;2592;10036224;4819379;0;4819379;470897;470897;4819379;491
ISIC_0008524;150;3;2;100.0;0.6;4288;2848;12212224;4910871;5649;4910871;323767;318118;4916520;160
ISIC_0003657;150;2;3;10.0;0.6;3024;2016;6096384;2215745;1986;2215745;340261;338275;2217731;149
ISIC_0014712;350;1;2;1.0;0.6;6621;4422;29278062;1259763;15588625;1259763;24292916;8704291;16848388;368
ISIC_0008524;250;2;1;10.0;0.6;4288;2848;12212224;4539290;7441;4539290;323767;316326;4546731;259
ISIC_0014623;350;1;1;10.0;0.6;2592;1936;5018112;1183034;940858;1183034;1937167;996309;2123892;364
ISIC_0003657;350;4;3;0.01;0.6;3024;2016;6096384;1448062;23457;1448062;340261;316804;1471519;416
ISIC_0003657;200;2;3;0.1;0.6;3024;2016;6096384;2011012;0;2011012;340261;340261;2011012;207
ISIC_0014428;150;2;3;1.0;0.6;4288;2848;12212224;2066579;0;2066579;525860;525860;2066579;148
ISIC_0013082;400;4;1;100.0;0.6;3872;2592;10036224;1834504;0;1834504;254836;254836;1834504;470
ISIC_0014623;300;4;3;1.0;0.6;2592;1936;5018112;1030160;1127991;1030160;1937167;809176;2158151;358
ISIC_0013082;250;4;3;10.0;0.6;3872;2592;10036224;2106429;0;2106429;254836;254836;2106429;299
ISIC_0008524;150;2;1;1.0;0.6;4288;2848;12212224;5139209;2614;5139209;323767;321153;5141823;138
ISIC_0003657;250;3;3;1.0;0.6;3024;2016;6096384;1719618;307;1719618;340261;339954;1719925;283
ISIC_0003657;50;2;3;10.0;0.6;3024;2016;6096384;2534563;72;2534563;340261;340189;2534635;29
ISIC_0013188;250;4;2;100.0;0.6;3008;2000;6016000;3820331;0;3820331;92544;92544;3820331;295
ISIC_0013188;300;3;1;0.01;0.6;3008;2000;6016000;3815241;0;3815241;92544;92544;3815241;331
ISIC_0014712;200;3;2;1.0;0.6;6621;4422;29278062;1514064;16606496;1514064;24292916;7686420;18120560;218
ISIC_0003657;100;3;2;0.01;0.6;3024;2016;6096384;2427570;17997;2427570;340261;322264;2445567;96
ISIC_0014712;200;3;1;100.0;0.6;6621;4422;29278062;1404141;16368496;1404141;24292916;7924420;17772637;215
ISIC_0007332;300;2;3;0.1;0.6;3024;2016;6096384;5042816;0;5042816;530766;530766;5042816;327
ISIC_0012547;50;4;2;1.0;0.6;4288;2848;12212224;10785544;0;10785544;572681;572681;10785544;53
ISIC_0008524;50;2;1;1.0;0.6;4288;2848;12212224;6132098;13882;6132098;323767;309885;6145980;18
ISIC_0013128;300;4;2;100.0;0.6;3872;2592;10036224;4966224;39;4966224;470897;470858;4966263;355
ISIC_0003657;350;1;3;0.01;0.6;3024;2016;6096384;1759773;17611;1759773;340261;322650;1777384;371
ISIC_0012547;400;1;1;10.0;0.6;4288;2848;12212224;11250166;0;11250166;572681;572681;11250166;424
ISIC_0014623;50;4;3;10.0;0.6;2592;1936;5018112;2054900;436700;2054900;1937167;1500467;2491600;59
ISIC_0007332;200;1;2;1.0;0.6;3024;2016;6096384;5166829;0;5166829;530766;530766;5166829;188
ISIC_0012547;50;4;3;1.0;0.6;4288;2848;12212224;10784089;0;10784089;572681;572681;10784089;58
ISIC_0013128;200;3;1;0.1;0.6;3872;2592;10036224;5611544;0;5611544;470897;470897;5611544;212
ISIC_0003657;250;4;2;1.0;0.6;3024;2016;6096384;1669002;307;1669002;340261;339954;1669309;293
ISIC_0013188;450;2;3;0.1;0.6;3008;2000;6016000;3124928;0;3124928;92544;92544;3124928;507
ISIC_0014428;200;4;2;100.0;0.6;4288;2848;12212224;1439200;999;1439200;525860;524861;1440199;235
ISIC_0013188;350;1;1;0.01;0.6;3008;2000;6016000;3656623;0;3656623;92544;92544;3656623;361
ISIC_0014623;250;4;2;0.01;0.6;2592;1936;5018112;1107958;1007257;1107958;1937167;929910;2115215;291
ISIC_0013082;350;2;2;0.01;0.6;3872;2592;10036224;1705316;0;1705316;254836;254836;1705316;381
ISIC_0014712;50;1;3;10.0;0.6;6621;4422;29278062;2825601;10386460;2825601;24292916;13906456;13212061;14
ISIC_0013188;400;2;2;1.0;0.6;3008;2000;6016000;3234154;0;3234154;92544;92544;3234154;443
ISIC_0008524;150;3;1;0.01;0.6;4288;2848;12212224;5266984;0;5266984;323767;323767;5266984;151
ISIC_0003657;400;2;3;1.0;0.6;3024;2016;6096384;1610110;4141;1610110;340261;336120;1614251;448
ISIC_0013128;100;3;1;0.1;0.6;3872;2592;10036224;6777483;0;6777483;470897;470897;6777483;92
ISIC_0013082;50;2;3;10.0;0.6;3872;2592;10036224;3809127;0;3809127;254836;254836;3809127;29
ISIC_0003657;200;2;3;0.01;0.6;3024;2016;6096384;2000280;22982;2000280;340261;317279;2023262;206
ISIC_0012547;450;2;3;0.01;0.6;4288;2848;12212224;11195553;74875;11195553;572681;497806;11270428;506
ISIC_0012547;400;4;2;0.1;0.6;4288;2848;12212224;11233139;91377;11233139;572681;481304;11324516;472
ISIC_0014428;150;3;2;100.0;0.6;4288;2848;12212224;1909875;990;1909875;525860;524870;1910865;160
ISIC_0013082;50;3;3;10.0;0.6;3872;2592;10036224;3809129;0;3809129;254836;254836;3809129;44
ISIC_0014712;150;2;3;100.0;0.6;6621;4422;29278062;1997847;15165184;1997847;24292916;9127732;17163031;150
ISIC_0013128;200;1;3;100.0;0.6;3872;2592;10036224;5755525;0;5755525;470897;470897;5755525;195
ISIC_0013082;50;2;3;0.01;0.6;3872;2592;10036224;3434509;7411;3434509;254836;247425;3441920;26
ISIC_0013082;450;2;3;10.0;0.6;3872;2592;10036224;1722794;1608;1722794;254836;253228;1724402;509
ISIC_0013188;50;3;2;0.1;0.6;3008;2000;6016000;5404291;0;5404291;92544;92544;5404291;37
ISIC_0013188;250;4;2;0.01;0.6;3008;2000;6016000;3988848;0;3988848;92544;92544;3988848;291
ISIC_0013082;100;3;1;0.1;0.6;3872;2592;10036224;2862885;4955;2862885;254836;249881;2867840;92
ISIC_0013128;250;1;3;100.0;0.6;3872;2592;10036224;5441512;0;5441512;470897;470897;5441512;255
ISIC_0013128;200;2;3;1.0;0.6;3872;2592;10036224;5660850;0;5660850;470897;470897;5660850;208
ISIC_0013188;450;2;1;10.0;0.6;3008;2000;6016000;3126233;0;3126233;92544;92544;3126233;499
ISIC_0014428;50;3;3;10.0;0.6;4288;2848;12212224;2715573;1211;2715573;525860;524649;2716784;44
ISIC_0003657;150;1;2;1.0;0.6;3024;2016;6096384;2458835;2033;2458835;340261;338228;2460868;128
ISIC_0014712;100;4;2;0.1;0.6;6621;4422;29278062;3200328;14759815;3200328;24292916;9533101;17960143;112
ISIC_0014712;400;2;2;1.0;0.6;6621;4422;29278062;1315878;17585639;1315878;24292916;6707277;18901517;443
ISIC_0012547;100;1;3;10.0;0.6;4288;2848;12212224;0;572681;0;572681;0;572681;74
ISIC_0008524;350;1;2;0.1;0.6;4288;2848;12212224;4290732;116;4290732;323767;323651;4290848;367
ISIC_0013082;200;4;1;0.1;0.6;3872;2592;10036224;2127754;9980;2127754;254836;244856;2137734;227
ISIC_0013082;150;2;2;1.0;0.6;3872;2592;10036224;2689867;2172;2689867;254836;252664;2692039;143
ISIC_0013128;250;1;2;0.1;0.6;3872;2592;10036224;5436020;0;5436020;470897;470897;5436020;247
ISIC_0008524;50;4;3;100.0;0.6;4288;2848;12212224;5717651;11966;5717651;323767;311801;5729617;60
ISIC_0014623;300;1;1;0.1;0.6;2592;1936;5018112;1213516;1003850;1213516;1937167;933317;2217366;302
ISIC_0008524;450;4;3;10.0;0.6;4288;2848;12212224;2777495;18436;2777495;323767;305331;2795931;539
ISIC_0013188;200;2;3;0.01;0.6;3008;2000;6016000;4122394;323;4122394;92544;92221;4122717;206
ISIC_0013128;300;1;3;0.01;0.6;3872;2592;10036224;5279925;0;5279925;470897;470897;5279925;311
ISIC_0014428;350;2;2;0.01;0.6;4288;2848;12212224;994400;239;994400;525860;525621;994639;381
ISIC_0007332;300;1;2;100.0;0.6;3024;2016;6096384;5108871;0;5108871;530766;530766;5108871;310
ISIC_0012547;150;3;3;10.0;0.6;4288;2848;12212224;11558318;0;11558318;572681;572681;11558318;164
ISIC_0013082;350;3;1;100.0;0.6;3872;2592;10036224;1955511;0;1955511;254836;254836;1955511;395
ISIC_0007332;300;1;2;0.01;0.6;3024;2016;6096384;5012743;0;5012743;530766;530766;5012743;306
ISIC_0012547;450;1;1;1.0;0.6;4288;2848;12212224;11280856;0;11280856;572681;572681;11280856;483
ISIC_0013128;250;4;1;0.01;0.6;3872;2592;10036224;5489752;0;5489752;470897;470897;5489752;286
ISIC_0012547;250;2;2;1.0;0.6;4288;2848;12212224;11493855;0;11493855;572681;572681;11493855;263
ISIC_0014712;50;1;3;1.0;0.6;6621;4422;29278062;2825643;10386385;2825643;24292916;13906531;13212028;13
ISIC_0013082;300;1;2;10.0;0.6;3872;2592;10036224;2201291;224;2201291;254836;254612;2201515;309
ISIC_0014623;250;2;2;1.0;0.6;2592;1936;5018112;1266600;966561;1266600;1937167;970606;2233161;263
ISIC_0003657;50;4;1;100.0;0.6;3024;2016;6096384;2078432;72;2078432;340261;340189;2078504;50
ISIC_0003657;400;1;3;1.0;0.6;3024;2016;6096384;1795924;3955;1795924;340261;336306;1799879;433
ISIC_0007332;350;2;3;10.0;0.6;3024;2016;6096384;4871964;0;4871964;530766;530766;4871964;389
ISIC_0003657;350;4;1;1.0;0.6;3024;2016;6096384;1524004;2927;1524004;340261;337334;1526931;408
ISIC_0014712;50;2;1;0.1;0.6;6621;4422;29278062;2457582;12901230;2457582;24292916;11391686;15358812;17
ISIC_0014428;400;1;2;100.0;0.6;4288;2848;12212224;1256533;1424;1256533;525860;524436;1257957;430
ISIC_0014623;400;2;2;1.0;0.6;2592;1936;5018112;1079537;1079262;1079537;1937167;857905;2158799;443
ISIC_0014623;250;2;3;10.0;0.6;2592;1936;5018112;1266684;966718;1266684;1937167;970449;2233402;269
ISIC_0012547;50;2;1;100.0;0.6;4288;2848;12212224;10811912;0;10811912;572681;572681;10811912;20
ISIC_0014712;150;4;1;10.0;0.6;6621;4422;29278062;1799378;16333380;1799378;24292916;7959536;18132758;169
ISIC_0013188;300;1;2;0.01;0.6;3008;2000;6016000;3739157;0;3739157;92544;92544;3739157;306
ISIC_0014623;50;1;3;100.0;0.6;2592;1936;5018112;2352619;423024;2352619;1937167;1514143;2775643;15
ISIC_0013128;400;3;1;100.0;0.6;3872;2592;10036224;4609405;0;4609405;470897;470897;4609405;455
ISIC_0013188;400;2;2;100.0;0.6;3008;2000;6016000;3250048;0;3250048;92544;92544;3250048;445
ISIC_0013188;150;1;1;1.0;0.6;3008;2000;6016000;4436626;0;4436626;92544;92544;4436626;123
ISIC_0013128;200;4;2;0.01;0.6;3872;2592;10036224;5571093;0;5571093;470897;470897;5571093;231
ISIC_0014712;250;4;1;10.0;0.6;6621;4422;29278062;1784643;17882225;1784643;24292916;6410691;19666868;289
ISIC_0014623;50;1;1;0.01;0.6;2592;1936;5018112;2583611;375324;2583611;1937167;1561843;2958935;1
ISIC_0008524;50;4;2;100.0;0.6;4288;2848;12212224;5717679;11966;5717679;323767;311801;5729645;55
ISIC_0013128;250;2;1;0.01;0.6;3872;2592;10036224;5574144;0;5574144;470897;470897;5574144;256
ISIC_0013188;450;3;1;100.0;0.6;3008;2000;6016000;3126231;0;3126231;92544;92544;3126231;515
ISIC_0007332;50;4;3;10.0;0.6;3024;2016;6096384;5150104;0;5150104;530766;530766;5150104;59
ISIC_0014712;350;2;3;0.1;0.6;6621;4422;29278062;1138503;17194485;1138503;24292916;7098431;18332988;387
ISIC_0007332;350;3;1;1.0;0.6;3024;2016;6096384;4872615;0;4872615;530766;530766;4872615;393
ISIC_0003657;100;4;1;0.01;0.6;3024;2016;6096384;2581020;0;2581020;340261;340261;2581020;106
ISIC_0014428;250;4;3;0.1;0.6;4288;2848;12212224;1264279;0;1264279;525860;525860;1264279;297
ISIC_0013082;350;3;3;0.1;0.6;3872;2592;10036224;1700225;0;1700225;254836;254836;1700225;402
ISIC_0012547;300;4;2;0.1;0.6;4288;2848;12212224;11384692;173802;11384692;572681;398879;11558494;352
ISIC_0013082;100;2;3;0.01;0.6;3872;2592;10036224;2745407;10494;2745407;254836;244342;2755901;86
ISIC_0013128;200;3;3;0.1;0.6;3872;2592;10036224;5663483;0;5663483;470897;470897;5663483;222
ISIC_0008524;100;1;1;1.0;0.6;4288;2848;12212224;5764755;1965;5764755;323767;321802;5766720;63
ISIC_0013188;200;4;3;10.0;0.6;3008;2000;6016000;3977681;0;3977681;92544;92544;3977681;239
ISIC_0003657;400;3;1;0.01;0.6;3024;2016;6096384;1626883;92;1626883;340261;340169;1626975;451
ISIC_0013128;300;4;1;100.0;0.6;3872;2592;10036224;4966378;39;4966378;470897;470858;4966417;350
ISIC_0014712;200;2;3;1.0;0.6;6621;4422;29278062;1518661;16464782;1518661;24292916;7828134;17983443;208
ISIC_0014712;50;3;3;100.0;0.6;6621;4422;29278062;2849626;13299681;2849626;24292916;10993235;16149307;45
ISIC_0014712;150;1;2;10.0;0.6;6621;4422;29278062;2009579;13809811;2009579;24292916;10483105;15819390;129
ISIC_0014428;450;4;2;0.1;0.6;4288;2848;12212224;851792;3713;851792;525860;522147;855505;532
ISIC_0013128;200;3;3;1.0;0.6;3872;2592;10036224;5614993;0;5614993;470897;470897;5614993;223
ISIC_0014712;200;1;1;0.01;0.6;6621;4422;29278062;1658766;14374520;1658766;24292916;9918396;16033286;181
ISIC_0007332;350;4;3;0.01;0.6;3024;2016;6096384;4723900;77;4723900;530766;530689;4723977;416
ISIC_0008524;350;1;3;0.01;0.6;4288;2848;12212224;4461914;1214;4461914;323767;322553;4463128;371
ISIC_0013082;150;2;1;10.0;0.6;3872;2592;10036224;2759695;183;2759695;254836;254653;2759878;139
ISIC_0012547;250;2;2;10.0;0.6;4288;2848;12212224;11494346;0;11494346;572681;572681;11494346;264
ISIC_0013082;50;1;3;10.0;0.6;3872;2592;10036224;3809127;0;3809127;254836;254836;3809127;14
ISIC_0003657;250;1;2;10.0;0.6;3024;2016;6096384;2034369;296;2034369;340261;339965;2034665;249
ISIC_0014428;50;1;2;0.1;0.6;4288;2848;12212224;3037381;0;3037381;525860;525860;3037381;7
ISIC_0007332;400;1;3;1.0;0.6;3024;2016;6096384;4811956;0;4811956;530766;530766;4811956;433
ISIC_0014623;150;4;2;1.0;0.6;2592;1936;5018112;1308204;917831;1308204;1937167;1019336;2226035;173
ISIC_0013128;300;1;3;1.0;0.6;3872;2592;10036224;5178720;55;5178720;470897;470842;5178775;313
ISIC_0013082;300;4;2;0.1;0.6;3872;2592;10036224;1955248;7710;1955248;254836;247126;1962958;352
ISIC_0008524;450;4;3;1.0;0.6;4288;2848;12212224;2777114;21931;2777114;323767;301836;2799045;538
ISIC_0014428;400;2;2;1.0;0.6;4288;2848;12212224;1045739;4595;1045739;525860;521265;1050334;443
ISIC_0012547;50;3;3;0.1;0.6;4288;2848;12212224;0;572681;0;572681;0;572681;42
ISIC_0008524;300;2;2;0.01;0.6;4288;2848;12212224;4471409;7;4471409;323767;323760;4471416;321
ISIC_0014623;150;4;2;10.0;0.6;2592;1936;5018112;1308360;886998;1308360;1937167;1050169;2195358;174
ISIC_0014712;150;1;2;1.0;0.6;6621;4422;29278062;2011432;13809457;2011432;24292916;10483459;15820889;128
ISIC_0014623;400;2;3;10.0;0.6;2592;1936;5018112;1079242;1079388;1079242;1937167;857779;2158630;449
ISIC_0014712;50;4;2;1.0;0.6;6621;4422;29278062;2260936;13772577;2260936;24292916;10520339;16033513;53
ISIC_0007332;200;2;3;1.0;0.6;3024;2016;6096384;5166114;0;5166114;530766;530766;5166114;208
ISIC_0013188;150;3;1;1.0;0.6;3008;2000;6016000;4436864;0;4436864;92544;92544;4436864;153
ISIC_0008524;50;1;3;1.0;0.6;4288;2848;12212224;6140136;13367;6140136;323767;310400;6153503;13
ISIC_0013188;350;4;2;10.0;0.6;3008;2000;6016000;3509674;0;3509674;92544;92544;3509674;414
ISIC_0014712;350;1;2;0.1;0.6;6621;4422;29278062;1138976;15995631;1138976;24292916;8297285;17134607;367
ISIC_0014623;450;2;1;100.0;0.6;2592;1936;5018112;1000898;1111209;1000898;1937167;825958;2112107;500
ISIC_0013188;200;1;1;1.0;0.6;3008;2000;6016000;4059084;0;4059084;92544;92544;4059084;183
ISIC_0013188;450;1;2;10.0;0.6;3008;2000;6016000;3139585;0;3139585;92544;92544;3139585;489
ISIC_0007332;450;4;3;1.0;0.6;3024;2016;6096384;4640740;83;4640740;530766;530683;4640823;538
ISIC_0013128;100;4;1;1.0;0.6;3872;2592;10036224;6459057;0;6459057;470897;470897;6459057;108
ISIC_0014428;300;3;1;100.0;0.6;4288;2848;12212224;1211474;1843;1211474;525860;524017;1213317;335
ISIC_0003657;50;1;1;0.1;0.6;3024;2016;6096384;3750872;488;3750872;340261;339773;3751360;2
ISIC_0008524;200;3;2;10.0;0.6;4288;2848;12212224;4547314;11825;4547314;323767;311942;4559139;219
ISIC_0013082;350;4;3;1.0;0.6;3872;2592;10036224;1953407;0;1953407;254836;254836;1953407;418
ISIC_0012547;350;2;1;100.0;0.6;4288;2848;12212224;11254074;36400;11254074;572681;536281;11290474;380
ISIC_0014712;400;2;1;10.0;0.6;6621;4422;29278062;1315899;17586458;1315899;24292916;6706458;18902357;439
ISIC_0013188;200;3;3;100.0;0.6;3008;2000;6016000;4007611;0;4007611;92544;92544;4007611;225
ISIC_0012547;400;2;1;0.01;0.6;4288;2848;12212224;11378152;0;11378152;572681;572681;11378152;436
ISIC_0012547;300;1;1;10.0;0.6;4288;2848;12212224;11388053;0;11388053;572681;572681;11388053;304
ISIC_0008524;150;4;2;10.0;0.6;4288;2848;12212224;4172718;5649;4172718;323767;318118;4178367;174
ISIC_0014428;150;1;1;10.0;0.6;4288;2848;12212224;2154405;990;2154405;525860;524870;2155395;124
ISIC_0013188;350;1;2;100.0;0.6;3008;2000;6016000;3526836;0;3526836;92544;92544;3526836;370
ISIC_0013082;450;2;3;100.0;0.6;3872;2592;10036224;1722804;1608;1722804;254836;253228;1724412;510
ISIC_0007332;150;2;1;0.01;0.6;3024;2016;6096384;5524962;0;5524962;530766;530766;5524962;136
ISIC_0014428;400;2;3;100.0;0.6;4288;2848;12212224;1140318;2796;1140318;525860;523064;1143114;450
ISIC_0007332;250;2;1;0.01;0.6;3024;2016;6096384;5171521;0;5171521;530766;530766;5171521;256
ISIC_0013128;250;4;1;100.0;0.6;3872;2592;10036224;5316532;0;5316532;470897;470897;5316532;290
ISIC_0013082;200;3;3;1.0;0.6;3872;2592;10036224;2130572;536;2130572;254836;254300;2131108;223
ISIC_0003657;100;4;2;0.01;0.6;3024;2016;6096384;2186349;22056;2186349;340261;318205;2208405;111
ISIC_0013082;100;1;3;10.0;0.6;3872;2592;10036224;3104031;0;3104031;254836;254836;3104031;74
ISIC_0003657;200;1;3;0.01;0.6;3024;2016;6096384;2216296;14092;2216296;340261;326169;2230388;191
ISIC_0013082;400;2;2;0.1;0.6;3872;2592;10036224;1604063;0;1604063;254836;254836;1604063;442
ISIC_0013188;300;2;3;100.0;0.6;3008;2000;6016000;3696097;45;3696097;92544;92499;3696142;330
ISIC_0003657;100;4;2;10.0;0.6;3024;2016;6096384;2310297;30;2310297;340261;340231;2310327;114
ISIC_0014428;300;1;1;0.01;0.6;4288;2848;12212224;1546034;381;1546034;525860;525479;1546415;301
ISIC_0012547;300;2;2;100.0;0.6;4288;2848;12212224;11388053;40804;11388053;572681;531877;11428857;325
ISIC_0007332;300;4;1;100.0;0.6;3024;2016;6096384;5067688;0;5067688;530766;530766;5067688;350
ISIC_0012547;450;2;2;100.0;0.6;4288;2848;12212224;11254268;54450;11254268;572681;518231;11308718;505
ISIC_0013082;300;3;3;0.01;0.6;3872;2592;10036224;1784835;7874;1784835;254836;246962;1792709;341
ISIC_0013188;100;1;2;0.1;0.6;3008;2000;6016000;4926657;0;4926657;92544;92544;4926657;67
ISIC_0014712;100;1;3;100.0;0.6;6621;4422;29278062;3652268;10960393;3652268;24292916;13332523;14612661;75
ISIC_0007332;200;3;1;0.01;0.6;3024;2016;6096384;5278246;0;5278246;530766;530766;5278246;211
ISIC_0003657;200;1;1;0.01;0.6;3024;2016;6096384;2480748;0;2480748;340261;340261;2480748;181
ISIC_0014712;150;2;3;0.1;0.6;6621;4422;29278062;1941712;15399364;1941712;24292916;8893552;17341076;147
ISIC_0014428;50;1;2;1.0;0.6;4288;2848;12212224;3159133;1573;3159133;525860;524287;3160706;8
ISIC_0014623;250;3;1;10.0;0.6;2592;1936;5018112;1187831;1026846;1187831;1937167;910321;2214677;274
ISIC_0008524;300;4;2;0.1;0.6;4288;2848;12212224;3677662;3275;3677662;323767;320492;3680937;352
ISIC_0014428;350;1;1;1.0;0.6;4288;2848;12212224;1266750;8825;1266750;525860;517035;1275575;363
ISIC_0013082;300;3;1;1.0;0.6;3872;2592;10036224;2131158;1547;2131158;254836;253289;2132705;333
ISIC_0003657;250;2;3;1.0;0.6;3024;2016;6096384;1824506;319;1824506;340261;339942;1824825;268
ISIC_0014623;250;3;3;0.1;0.6;2592;1936;5018112;1191428;1009312;1191428;1937167;927855;2200740;282
ISIC_0013128;100;2;2;10.0;0.6;3872;2592;10036224;6775948;0;6775948;470897;470897;6775948;84
ISIC_0013188;150;3;2;1.0;0.6;3008;2000;6016000;4436845;0;4436845;92544;92544;4436845;158
ISIC_0003657;200;2;3;1.0;0.6;3024;2016;6096384;1908124;372;1908124;340261;339889;1908496;208
ISIC_0014428;100;2;2;100.0;0.6;4288;2848;12212224;2634285;534;2634285;525860;525326;2634819;85
ISIC_0014623;350;1;3;0.1;0.6;2592;1936;5018112;1166108;955724;1166108;1937167;981443;2121832;372
ISIC_0003657;100;1;2;0.01;0.6;3024;2016;6096384;2917178;6622;2917178;340261;333639;2923800;66
ISIC_0003657;450;4;3;100.0;0.6;3024;2016;6096384;1372912;1807;1372912;340261;338454;1374719;540
ISIC_0012547;300;1;3;0.01;0.6;4288;2848;12212224;11435677;0;11435677;572681;572681;11435677;311
ISIC_0014623;100;1;1;0.1;0.6;2592;1936;5018112;1819748;599764;1819748;1937167;1337403;2419512;62
ISIC_0013082;250;2;1;0.1;0.6;3872;2592;10036224;1920069;3154;1920069;254836;251682;1923223;257
ISIC_0003657;100;2;2;0.1;0.6;3024;2016;6096384;2594831;69;2594831;340261;340192;2594900;82
ISIC_0007332;100;3;1;10.0;0.6;3024;2016;6096384;0;530766;0;530766;0;530766;94
ISIC_0013082;50;3;2;0.1;0.6;3872;2592;10036224;3446472;2369;3446472;254836;252467;3448841;37
ISIC_0014623;50;3;2;10.0;0.6;2592;1936;5018112;2054520;436552;2054520;1937167;1500615;2491072;39
ISIC_0008524;450;3;1;0.1;0.6;4288;2848;12212224;3694035;9378;3694035;323767;314389;3703413;512
ISIC_0008524;200;1;1;0.01;0.6;4288;2848;12212224;4964093;0;4964093;323767;323767;4964093;181
ISIC_0012547;50;1;2;1.0;0.6;4288;2848;12212224;10804311;0;10804311;572681;572681;10804311;8
ISIC_0014712;450;2;3;0.01;0.6;6621;4422;29278062;926429;18023146;926429;24292916;6269770;18949575;506
ISIC_0014712;450;4;1;100.0;0.6;6621;4422;29278062;1058245;19009863;1058245;24292916;5283053;20068108;530
ISIC_0014712;250;1;3;0.1;0.6;6621;4422;29278062;2009731;15415203;2009731;24292916;8877713;17424934;252
ISIC_0013128;200;1;3;10.0;0.6;3872;2592;10036224;5755525;0;5755525;470897;470897;5755525;194
ISIC_0003657;200;3;1;100.0;0.6;3024;2016;6096384;1814201;1527;1814201;340261;338734;1815728;215
ISIC_0003657;50;2;1;0.1;0.6;3024;2016;6096384;3300264;403;3300264;340261;339858;3300667;17
ISIC_0013188;250;2;1;0.01;0.6;3008;2000;6016000;3979634;0;3979634;92544;92544;3979634;256
ISIC_0013082;350;4;1;0.01;0.6;3872;2592;10036224;1934206;0;1934206;254836;254836;1934206;406
ISIC_0014428;450;2;3;100.0;0.6;4288;2848;12212224;1156198;8163;1156198;525860;517697;1164361;510
ISIC_0012547;150;3;2;100.0;0.6;4288;2848;12212224;11558318;0;11558318;572681;572681;11558318;160
ISIC_0014712;100;1;2;10.0;0.6;6621;4422;29278062;3652301;10960576;3652301;24292916;13332340;14612877;69
ISIC_0013128;300;4;3;0.1;0.6;3872;2592;10036224;4956183;0;4956183;470897;470897;4956183;357
ISIC_0003657;400;3;2;0.01;0.6;3024;2016;6096384;1530157;15994;1530157;340261;324267;1546151;456
ISIC_0014428;250;1;2;1.0;0.6;4288;2848;12212224;1514936;0;1514936;525860;525860;1514936;248
ISIC_0014712;200;3;1;0.1;0.6;6621;4422;29278062;1503277;16790242;1503277;24292916;7502674;18293519;212
ISIC_0012547;300;1;2;0.01;0.6;4288;2848;12212224;11433482;0;11433482;572681;572681;11433482;306
ISIC_0003657;150;1;3;10.0;0.6;3024;2016;6096384;2377437;1986;2377437;340261;338275;2379423;134
ISIC_0014428;100;2;1;0.01;0.6;4288;2848;12212224;2779460;0;2779460;525860;525860;2779460;76
ISIC_0013128;250;2;1;1.0;0.6;3872;2592;10036224;5441516;0;5441516;470897;470897;5441516;258
ISIC_0013082;400;1;2;0.1;0.6;3872;2592;10036224;1580838;0;1580838;254836;254836;1580838;427
ISIC_0003657;450;1;3;10.0;0.6;3024;2016;6096384;1694939;1807;1694939;340261;338454;1696746;494
ISIC_0014712;100;1;3;0.01;0.6;6621;4422;29278062;3717086;11188177;3717086;24292916;13104739;14905263;71
ISIC_0013188;350;3;3;0.1;0.6;3008;2000;6016000;3390963;0;3390963;92544;92544;3390963;402
ISIC_0008524;150;3;2;1.0;0.6;4288;2848;12212224;5055529;2664;5055529;323767;321103;5058193;158
ISIC_0013128;250;2;3;10.0;0.6;3872;2592;10036224;5441792;0;5441792;470897;470897;5441792;269
ISIC_0014623;400;1;2;10.0;0.6;2592;1936;5018112;1185963;966885;1185963;1937167;970282;2152848;429
ISIC_0014428;350;4;3;100.0;0.6;4288;2848;12212224;1197904;6259;1197904;525860;519601;1204163;420
ISIC_0003657;300;1;3;1.0;0.6;3024;2016;6096384;1919528;2806;1919528;340261;337455;1922334;313
ISIC_0014712;50;4;3;10.0;0.6;6621;4422;29278062;2259568;13772366;2259568;24292916;10520550;16031934;59
ISIC_0013188;150;4;1;0.01;0.6;3008;2000;6016000;4548992;0;4548992;92544;92544;4548992;166
ISIC_0014428;300;1;2;100.0;0.6;4288;2848;12212224;1337724;1843;1337724;525860;524017;1339567;310
ISIC_0012547;150;3;3;0.01;0.6;4288;2848;12212224;0;572681;0;572681;0;572681;161
ISIC_0014428;400;4;2;1.0;0.6;4288;2848;12212224;984189;4747;984189;525860;521113;988936;473
ISIC_0003657;350;3;3;0.01;0.6;3024;2016;6096384;1620138;15738;1620138;340261;324523;1635876;401
ISIC_0013082;300;3;3;10.0;0.6;3872;2592;10036224;2201183;224;2201183;254836;254612;2201407;344
ISIC_0013188;450;2;2;10.0;0.6;3008;2000;6016000;3126131;0;3126131;92544;92544;3126131;504
ISIC_0014712;450;4;2;1.0;0.6;6621;4422;29278062;1058209;19009610;1058209;24292916;5283306;20067819;533
ISIC_0013082;250;2;3;10.0;0.6;3872;2592;10036224;2106429;0;2106429;254836;254836;2106429;269
ISIC_0013128;250;2;1;10.0;0.6;3872;2592;10036224;5441595;0;5441595;470897;470897;5441595;259
ISIC_0012547;50;3;1;10.0;0.6;4288;2848;12212224;10811912;0;10811912;572681;572681;10811912;34
ISIC_0014712;300;2;1;0.1;0.6;6621;4422;29278062;1371916;17282560;1371916;24292916;7010356;18654476;317
ISIC_0014623;450;2;2;100.0;0.6;2592;1936;5018112;1000765;1111208;1000765;1937167;825959;2111973;505
ISIC_0013082;100;4;1;0.1;0.6;3872;2592;10036224;2863090;4922;2863090;254836;249914;2868012;107
ISIC_0007332;350;4;2;100.0;0.6;3024;2016;6096384;4854669;0;4854669;530766;530766;4854669;415
ISIC_0012547;400;3;1;0.01;0.6;4288;2848;12212224;11393824;0;11393824;572681;572681;11393824;451
ISIC_0013188;350;4;3;0.01;0.6;3008;2000;6016000;3425980;1215;3425980;92544;91329;3427195;416
ISIC_0013188;400;1;2;10.0;0.6;3008;2000;6016000;3265043;0;3265043;92544;92544;3265043;429
ISIC_0012547;250;3;1;1.0;0.6;4288;2848;12212224;11493864;0;11493864;572681;572681;11493864;273
ISIC_0008524;400;2;1;1.0;0.6;4288;2848;12212224;4010293;3636;4010293;323767;320131;4013929;438
ISIC_0007332;450;3;3;0.1;0.6;3024;2016;6096384;4590284;277;4590284;530766;530489;4590561;522
ISIC_0008524;350;3;2;1.0;0.6;4288;2848;12212224;4102162;5200;4102162;323767;318567;4107362;398
ISIC_0014712;400;3;3;10.0;0.6;6621;4422;29278062;1239198;17659384;1239198;24292916;6633532;18898582;464
ISIC_0014623;200;4;3;0.1;0.6;2592;1936;5018112;1138008;952966;1138008;1937167;984201;2090974;237
ISIC_0003657;450;2;1;1.0;0.6;3024;2016;6096384;1550932;1871;1550932;340261;338390;1552803;498
ISIC_0013082;300;1;2;0.01;0.6;3872;2592;10036224;1945234;9629;1945234;254836;245207;1954863;306
ISIC_0013188;400;3;2;1.0;0.6;3008;2000;6016000;3234268;0;3234268;92544;92544;3234268;458
ISIC_0014623;50;2;2;1.0;0.6;2592;1936;5018112;2054529;437140;2054529;1937167;1500027;2491669;23
ISIC_0014712;300;3;3;0.01;0.6;6621;4422;29278062;1339227;17455124;1339227;24292916;6837792;18794351;341
ISIC_0014712;400;1;3;100.0;0.6;6621;4422;29278062;1404238;16479721;1404238;24292916;7813195;17883959;435
ISIC_0012547;250;3;1;100.0;0.6;4288;2848;12212224;11494346;0;11494346;572681;572681;11494346;275
ISIC_0014712;250;3;1;10.0;0.6;6621;4422;29278062;1784643;17066028;1784643;24292916;7226888;18850671;274
ISIC_0008524;350;4;3;100.0;0.6;4288;2848;12212224;3333252;277;3333252;323767;323490;3333529;420
ISIC_0007332;450;2;3;100.0;0.6;3024;2016;6096384;4683750;83;4683750;530766;530683;4683833;510
ISIC_0013128;300;2;3;0.01;0.6;3872;2592;10036224;5143681;0;5143681;470897;470897;5143681;326
ISIC_0013188;400;2;2;0.1;0.6;3008;2000;6016000;3115473;0;3115473;92544;92544;3115473;442
ISIC_0007332;200;4;2;10.0;0.6;3024;2016;6096384;5168918;0;5168918;530766;530766;5168918;234
ISIC_0008524;50;2;1;0.1;0.6;4288;2848;12212224;7149640;0;7149640;323767;323767;7149640;17
ISIC_0013188;150;3;3;0.01;0.6;3008;2000;6016000;4580280;0;4580280;92544;92544;4580280;161
ISIC_0007332;300;1;2;0.1;0.6;3024;2016;6096384;5021433;0;5021433;530766;530766;5021433;307
ISIC_0013128;50;3;2;10.0;0.6;3872;2592;10036224;6971248;0;6971248;470897;470897;6971248;39
ISIC_0008524;300;4;2;0.01;0.6;4288;2848;12212224;3820597;16;3820597;323767;323751;3820613;351
ISIC_0014428;450;4;3;0.1;0.6;4288;2848;12212224;763168;5882;763168;525860;519978;769050;537
ISIC_0003657;50;2;3;100.0;0.6;3024;2016;6096384;2534923;72;2534923;340261;340189;2534995;30
ISIC_0014712;150;1;1;10.0;0.6;6621;4422;29278062;2009579;13809811;2009579;24292916;10483105;15819390;124
ISIC_0014428;300;2;3;0.01;0.6;4288;2848;12212224;1127091;5326;1127091;525860;520534;1132417;326
ISIC_0012547;450;4;1;0.01;0.6;4288;2848;12212224;11379897;101670;11379897;572681;471011;11481567;526
ISIC_0013188;450;3;3;0.1;0.6;3008;2000;6016000;3129000;0;3129000;92544;92544;3129000;522
ISIC_0014428;100;1;3;10.0;0.6;4288;2848;12212224;2634488;536;2634488;525860;525324;2635024;74
ISIC_0007332;350;4;3;10.0;0.6;3024;2016;6096384;4854540;0;4854540;530766;530766;4854540;419
ISIC_0014712;350;4;3;1.0;0.6;6621;4422;29278062;1245619;18094873;1245619;24292916;6198043;19340492;418
ISIC_0014623;250;4;1;1.0;0.6;2592;1936;5018112;1086225;1046811;1086225;1937167;890356;2133036;288
ISIC_0007332;300;1;3;10.0;0.6;3024;2016;6096384;5108871;0;5108871;530766;530766;5108871;314
ISIC_0014428;450;2;3;1.0;0.6;4288;2848;12212224;1176289;1319;1176289;525860;524541;1177608;508
ISIC_0013128;200;1;2;100.0;0.6;3872;2592;10036224;5755525;0;5755525;470897;470897;5755525;190
ISIC_0014428;300;2;1;1.0;0.6;4288;2848;12212224;1165665;2312;1165665;525860;523548;1167977;318
ISIC_0012547;400;2;2;0.01;0.6;4288;2848;12212224;11383086;0;11383086;572681;572681;11383086;441
ISIC_0007332;300;3;3;0.1;0.6;3024;2016;6096384;5039961;0;5039961;530766;530766;5039961;342
ISIC_0013082;250;3;3;10.0;0.6;3872;2592;10036224;2106429;0;2106429;254836;254836;2106429;284
ISIC_0014712;150;1;1;1.0;0.6;6621;4422;29278062;2011432;13809457;2011432;24292916;10483459;15820889;123
ISIC_0013128;450;3;3;0.01;0.6;3872;2592;10036224;4532966;0;4532966;470897;470897;4532966;521
ISIC_0014623;400;1;2;100.0;0.6;2592;1936;5018112;1185961;966885;1185961;1937167;970282;2152846;430
ISIC_0014712;50;1;1;1.0;0.6;6621;4422;29278062;2825651;10385678;2825651;24292916;13907238;13211329;3
ISIC_0003657;50;4;3;10.0;0.6;3024;2016;6096384;2078141;72;2078141;340261;340189;2078213;59
ISIC_0014428;400;1;3;0.1;0.6;4288;2848;12212224;1030958;1096;1030958;525860;524764;1032054;432
ISIC_0014712;300;4;1;10.0;0.6;6621;4422;29278062;1314374;18365158;1314374;24292916;5927758;19679532;349
ISIC_0013128;300;4;2;0.1;0.6;3872;2592;10036224;4955821;0;4955821;470897;470897;4955821;352
ISIC_0014712;100;3;2;1.0;0.6;6621;4422;29278062;3327053;12430132;3327053;24292916;11862784;15757185;98
ISIC_0013082;400;4;3;1.0;0.6;3872;2592;10036224;1814145;0;1814145;254836;254836;1814145;478
ISIC_0014428;400;3;2;1.0;0.6;4288;2848;12212224;1014212;4516;1014212;525860;521344;1018728;458
ISIC_0013188;350;3;1;10.0;0.6;3008;2000;6016000;3509667;0;3509667;92544;92544;3509667;394
ISIC_0007332;50;2;2;10.0;0.6;3024;2016;6096384;5139560;0;5139560;530766;530766;5139560;24
ISIC_0014428;250;3;2;0.1;0.6;4288;2848;12212224;1284127;0;1284127;525860;525860;1284127;277
ISIC_0003657;350;1;1;10.0;0.6;3024;2016;6096384;1804580;2927;1804580;340261;337334;1807507;364
ISIC_0014623;450;2;2;1.0;0.6;2592;1936;5018112;1000885;1111066;1000885;1937167;826101;2111951;503
ISIC_0014623;250;3;2;0.01;0.6;2592;1936;5018112;1208438;955383;1208438;1937167;981784;2163821;276
ISIC_0013128;250;4;1;10.0;0.6;3872;2592;10036224;5316532;0;5316532;470897;470897;5316532;289
ISIC_0003657;150;1;2;0.01;0.6;3024;2016;6096384;2475685;11543;2475685;340261;328718;2487228;126
ISIC_0013128;100;1;2;1.0;0.6;3872;2592;10036224;6977105;0;6977105;470897;470897;6977105;68
ISIC_0014712;300;3;1;0.1;0.6;6621;4422;29278062;1367564;17679628;1367564;24292916;6613288;19047192;332
ISIC_0013082;150;4;2;0.01;0.6;3872;2592;10036224;2731738;0;2731738;254836;254836;2731738;171
ISIC_0013188;350;1;2;1.0;0.6;3008;2000;6016000;3507655;0;3507655;92544;92544;3507655;368
ISIC_0008524;450;3;1;10.0;0.6;4288;2848;12212224;3650389;18436;3650389;323767;305331;3668825;514
ISIC_0013082;350;1;1;10.0;0.6;3872;2592;10036224;1955526;0;1955526;254836;254836;1955526;364
ISIC_0013188;100;3;2;1.0;0.6;3008;2000;6016000;4800575;0;4800575;92544;92544;4800575;98
ISIC_0014623;450;3;3;10.0;0.6;2592;1936;5018112;954437;1178551;954437;1937167;758616;2132988;524
ISIC_0013188;450;1;3;100.0;0.6;3008;2000;6016000;3139727;0;3139727;92544;92544;3139727;495
ISIC_0012547;250;3;3;0.1;0.6;4288;2848;12212224;11534062;0;11534062;572681;572681;11534062;282
ISIC_0013082;100;4;3;0.01;0.6;3872;2592;10036224;2742538;10383;2742538;254836;244453;2752921;116
ISIC_0013082;350;4;3;100.0;0.6;3872;2592;10036224;1955510;0;1955510;254836;254836;1955510;420
ISIC_0007332;250;4;1;0.1;0.6;3024;2016;6096384;5105389;1164;5105389;530766;529602;5106553;287
ISIC_0013128;400;4;1;10.0;0.6;3872;2592;10036224;4483555;0;4483555;470897;470897;4483555;469
ISIC_0003657;350;1;3;10.0;0.6;3024;2016;6096384;1804726;2927;1804726;340261;337334;1807653;374
ISIC_0013188;450;4;2;100.0;0.6;3008;2000;6016000;3126247;0;3126247;92544;92544;3126247;535
ISIC_0014712;250;4;1;0.01;0.6;6621;4422;29278062;1646460;17982787;1646460;24292916;6310129;19629247;286
ISIC_0014712;150;3;2;100.0;0.6;6621;4422;29278062;1997847;15360548;1997847;24292916;8932368;17358395;160
ISIC_0007332;400;2;2;10.0;0.6;3024;2016;6096384;4811876;0;4811876;530766;530766;4811876;444
ISIC_0014712;100;4;1;0.1;0.6;6621;4422;29278062;3198993;14459237;3198993;24292916;9833679;17658230;107
ISIC_0013188;100;1;2;1.0;0.6;3008;2000;6016000;4863205;0;4863205;92544;92544;4863205;68
ISIC_0014428;400;4;3;100.0;0.6;4288;2848;12212224;1078368;2796;1078368;525860;523064;1081164;480
ISIC_0014712;300;3;3;100.0;0.6;6621;4422;29278062;1314378;17477830;1314378;24292916;6815086;18792208;345
ISIC_0013188;200;1;1;0.01;0.6;3008;2000;6016000;4355078;0;4355078;92544;92544;4355078;181
ISIC_0013128;350;4;1;10.0;0.6;3872;2592;10036224;4753794;0;4753794;470897;470897;4753794;409
ISIC_0014623;150;2;3;10.0;0.6;2592;1936;5018112;1568494;753652;1568494;1937167;1183515;2322146;149
ISIC_0008524;400;1;3;0.01;0.6;4288;2848;12212224;4094943;10742;4094943;323767;313025;4105685;431
ISIC_0013082;450;3;3;100.0;0.6;3872;2592;10036224;1722804;1608;1722804;254836;253228;1724412;525
ISIC_0008524;450;2;3;1.0;0.6;4288;2848;12212224;3892015;14421;3892015;323767;309346;3906436;508
ISIC_0013128;450;3;3;10.0;0.6;3872;2592;10036224;4620859;0;4620859;470897;470897;4620859;524
ISIC_0014712;50;3;1;0.1;0.6;6621;4422;29278062;2458099;12896312;2458099;24292916;11396604;15354411;32
ISIC_0014623;450;3;2;100.0;0.6;2592;1936;5018112;954530;1178444;954530;1937167;758723;2132974;520
ISIC_0013188;200;4;2;0.1;0.6;3008;2000;6016000;4002663;0;4002663;92544;92544;4002663;232
ISIC_0014712;50;1;2;1.0;0.6;6621;4422;29278062;2825648;10385937;2825648;24292916;13906979;13211585;8
ISIC_0008524;200;3;2;100.0;0.6;4288;2848;12212224;4547386;11825;4547386;323767;311942;4559211;220
ISIC_0014428;150;3;1;10.0;0.6;4288;2848;12212224;1909875;990;1909875;525860;524870;1910865;154
ISIC_0013082;150;1;3;100.0;0.6;3872;2592;10036224;2759697;183;2759697;254836;254653;2759880;135
ISIC_0013128;350;3;1;1.0;0.6;3872;2592;10036224;4845822;0;4845822;470897;470897;4845822;393
ISIC_0003657;250;1;2;0.1;0.6;3024;2016;6096384;2060718;566;2060718;340261;339695;2061284;247
ISIC_0003657;300;1;2;0.1;0.6;3024;2016;6096384;1909581;0;1909581;340261;340261;1909581;307
ISIC_0014623;200;1;1;0.01;0.6;2592;1936;5018112;1530053;773616;1530053;1937167;1163551;2303669;181
ISIC_0007332;150;3;3;0.1;0.6;3024;2016;6096384;5481257;0;5481257;530766;530766;5481257;162
ISIC_0013082;200;1;1;100.0;0.6;3872;2592;10036224;2123932;200;2123932;254836;254636;2124132;185
ISIC_0014623;50;1;1;100.0;0.6;2592;1936;5018112;2352651;423084;2352651;1937167;1514083;2775735;5
ISIC_0003657;250;3;2;1.0;0.6;3024;2016;6096384;1745759;307;1745759;340261;339954;1746066;278
ISIC_0014428;200;4;3;10.0;0.6;4288;2848;12212224;1439184;999;1439184;525860;524861;1440183;239
ISIC_0012547;450;2;3;1.0;0.6;4288;2848;12212224;11253654;54450;11253654;572681;518231;11308104;508
ISIC_0007332;250;2;2;0.1;0.6;3024;2016;6096384;5126939;367;5126939;530766;530399;5127306;262
ISIC_0012547;250;3;3;100.0;0.6;4288;2848;12212224;11494346;0;11494346;572681;572681;11494346;285
ISIC_0012547;100;1;1;100.0;0.6;4288;2848;12212224;0;572681;0;572681;0;572681;65
ISIC_0014623;350;3;1;0.01;0.6;2592;1936;5018112;1080495;1083015;1080495;1937167;854152;2163510;391
ISIC_0012547;300;1;2;10.0;0.6;4288;2848;12212224;11388053;0;11388053;572681;572681;11388053;309
ISIC_0012547;300;3;1;1.0;0.6;4288;2848;12212224;11302884;81608;11302884;572681;491073;11384492;333
ISIC_0013128;350;2;1;10.0;0.6;3872;2592;10036224;4996169;0;4996169;470897;470897;4996169;379
ISIC_0003657;250;4;2;10.0;0.6;3024;2016;6096384;1668864;296;1668864;340261;339965;1669160;294
ISIC_0014623;150;3;3;100.0;0.6;2592;1936;5018112;1369179;887058;1369179;1937167;1050109;2256237;165
ISIC_0013188;400;2;1;1.0;0.6;3008;2000;6016000;3234307;0;3234307;92544;92544;3234307;438
ISIC_0012547;100;1;2;0.01;0.6;4288;2848;12212224;0;572681;0;572681;0;572681;66
ISIC_0014428;200;3;1;0.01;0.6;4288;2848;12212224;1616337;0;1616337;525860;525860;1616337;211
ISIC_0012547;350;4;3;0.01;0.6;4288;2848;12212224;11323758;141694;11323758;572681;430987;11465452;416
ISIC_0014428;50;4;2;10.0;0.6;4288;2848;12212224;2715599;1211;2715599;525860;524649;2716810;54
ISIC_0012547;200;4;3;0.1;0.6;4288;2848;12212224;11512870;75251;11512870;572681;497430;11588121;237
ISIC_0008524;200;4;1;0.1;0.6;4288;2848;12212224;4178426;9709;4178426;323767;314058;4188135;227
ISIC_0014712;300;2;3;100.0;0.6;6621;4422;29278062;1318803;17086951;1318803;24292916;7205965;18405754;330
ISIC_0013188;100;2;1;100.0;0.6;3008;2000;6016000;4801215;0;4801215;92544;92544;4801215;80
ISIC_0007332;350;2;3;100.0;0.6;3024;2016;6096384;4871964;0;4871964;530766;530766;4871964;390
ISIC_0014428;300;4;3;1.0;0.6;4288;2848;12212224;1124920;2280;1124920;525860;523580;1127200;358
ISIC_0013128;200;3;2;0.1;0.6;3872;2592;10036224;5613112;0;5613112;470897;470897;5613112;217
ISIC_0007332;300;4;1;0.1;0.6;3024;2016;6096384;4987707;0;4987707;530766;530766;4987707;347
ISIC_0013188;400;1;1;100.0;0.6;3008;2000;6016000;3265146;0;3265146;92544;92544;3265146;425
ISIC_0014712;200;3;3;0.1;0.6;6621;4422;29278062;1503813;16787345;1503813;24292916;7505571;18291158;222
ISIC_0012547;450;4;2;1.0;0.6;4288;2848;12212224;11089322;108862;11089322;572681;463819;11198184;533
ISIC_0014623;150;4;2;0.1;0.6;2592;1936;5018112;1315918;910860;1315918;1937167;1026307;2226778;172
ISIC_0013082;450;3;1;0.1;0.6;3872;2592;10036224;1564737;0;1564737;254836;254836;1564737;512
ISIC_0007332;50;3;2;1.0;0.6;3024;2016;6096384;5116918;0;5116918;530766;530766;5116918;38
ISIC_0008524;200;3;2;0.01;0.6;4288;2848;12212224;4866155;0;4866155;323767;323767;4866155;216
ISIC_0013188;350;1;3;10.0;0.6;3008;2000;6016000;3527519;0;3527519;92544;92544;3527519;374
ISIC_0013128;100;1;3;0.1;0.6;3872;2592;10036224;6874199;0;6874199;470897;470897;6874199;72
ISIC_0003657;400;4;1;10.0;0.6;3024;2016;6096384;1481929;3890;1481929;340261;336371;1485819;469
ISIC_0013128;250;1;1;100.0;0.6;3872;2592;10036224;5441594;0;5441594;470897;470897;5441594;245
ISIC_0014428;150;2;2;0.01;0.6;4288;2848;12212224;1986377;0;1986377;525860;525860;1986377;141
ISIC_0013128;50;4;2;1.0;0.6;3872;2592;10036224;6780224;0;6780224;470897;470897;6780224;53
ISIC_0012547;150;3;1;100.0;0.6;4288;2848;12212224;11558318;0;11558318;572681;572681;11558318;155
ISIC_0007332;150;1;2;0.01;0.6;3024;2016;6096384;5504208;3075;5504208;530766;527691;5507283;126
ISIC_0014712;100;3;1;0.1;0.6;6621;4422;29278062;3198460;12958034;3198460;24292916;11334882;16156494;92
ISIC_0008524;450;1;1;100.0;0.6;4288;2848;12212224;4007581;18436;4007581;323767;305331;4026017;485
ISIC_0014623;200;3;3;1.0;0.6;2592;1936;5018112;1235694;944597;1235694;1937167;992570;2180291;223
ISIC_0014428;450;3;1;0.1;0.6;4288;2848;12212224;897575;0;897575;525860;525860;897575;512
ISIC_0012547;300;4;3;10.0;0.6;4288;2848;12212224;11305115;163216;11305115;572681;409465;11468331;359
ISIC_0014428;400;2;3;10.0;0.6;4288;2848;12212224;1140318;2796;1140318;525860;523064;1143114;449
ISIC_0014623;450;3;2;0.1;0.6;2592;1936;5018112;939888;1178538;939888;1937167;758629;2118426;517
ISIC_0013082;250;2;1;0.01;0.6;3872;2592;10036224;2254891;0;2254891;254836;254836;2254891;256
ISIC_0013128;200;3;1;10.0;0.6;3872;2592;10036224;5570725;0;5570725;470897;470897;5570725;214
ISIC_0014712;450;3;1;1.0;0.6;6621;4422;29278062;1061952;18360304;1061952;24292916;5932612;19422256;513
ISIC_0013082;50;1;1;10.0;0.6;3872;2592;10036224;3808920;0;3808920;254836;254836;3808920;4
ISIC_0013082;150;1;2;0.01;0.6;3872;2592;10036224;2654636;0;2654636;254836;254836;2654636;126
ISIC_0014712;350;3;2;0.01;0.6;6621;4422;29278062;1140072;17374751;1140072;24292916;6918165;18514823;396
ISIC_0014428;50;3;3;0.1;0.6;4288;2848;12212224;3041140;0;3041140;525860;525860;3041140;42
ISIC_0013128;50;2;3;100.0;0.6;3872;2592;10036224;6971244;0;6971244;470897;470897;6971244;30
ISIC_0012547;300;3;2;0.1;0.6;4288;2848;12212224;11380138;48386;11380138;572681;524295;11428524;337
ISIC_0012547;50;1;3;0.01;0.6;4288;2848;12212224;0;572681;0;572681;0;572681;11
ISIC_0013082;300;4;1;0.01;0.6;3872;2592;10036224;2175314;2480;2175314;254836;252356;2177794;346
ISIC_0013188;300;2;1;100.0;0.6;3008;2000;6016000;3695991;45;3695991;92544;92499;3696036;320
ISIC_0013082;400;1;2;10.0;0.6;3872;2592;10036224;1809384;0;1809384;254836;254836;1809384;429
ISIC_0008524;150;3;1;0.1;0.6;4288;2848;12212224;5190397;0;5190397;323767;323767;5190397;152
ISIC_0014712;150;1;3;0.1;0.6;6621;4422;29278062;1953234;14047550;1953234;24292916;10245366;16000784;132
ISIC_0014712;200;4;3;0.1;0.6;6621;4422;29278062;1336868;17904069;1336868;24292916;6388847;19240937;237
ISIC_0013128;250;3;2;0.01;0.6;3872;2592;10036224;5531152;0;5531152;470897;470897;5531152;276
ISIC_0012547;150;3;3;0.1;0.6;4288;2848;12212224;11550670;0;11550670;572681;572681;11550670;162
ISIC_0014428;100;2;2;10.0;0.6;4288;2848;12212224;2634491;538;2634491;525860;525322;2635029;84
ISIC_0014428;150;2;2;1.0;0.6;4288;2848;12212224;2066560;0;2066560;525860;525860;2066560;143
ISIC_0013128;100;3;3;0.1;0.6;3872;2592;10036224;6653692;0;6653692;470897;470897;6653692;102
ISIC_0008524;400;3;1;100.0;0.6;4288;2848;12212224;3931582;13085;3931582;323767;310682;3944667;455
ISIC_0012547;250;1;1;0.1;0.6;4288;2848;12212224;11533521;0;11533521;572681;572681;11533521;242
ISIC_0008524;400;2;1;100.0;0.6;4288;2848;12212224;3997306;13085;3997306;323767;310682;4010391;440
ISIC_0013082;150;3;2;10.0;0.6;3872;2592;10036224;2759695;183;2759695;254836;254653;2759878;159
ISIC_0007332;350;2;2;100.0;0.6;3024;2016;6096384;4872093;0;4872093;530766;530766;4872093;385
ISIC_0014428;300;3;1;0.01;0.6;4288;2848;12212224;1406154;402;1406154;525860;525458;1406556;331
ISIC_0007332;100;2;2;10.0;0.6;3024;2016;6096384;0;530766;0;530766;0;530766;84
ISIC_0013082;300;2;2;1.0;0.6;3872;2592;10036224;2165404;1427;2165404;254836;253409;2166831;323
ISIC_0014712;350;2;2;10.0;0.6;6621;4422;29278062;1252247;17087981;1252247;24292916;7204935;18340228;384
ISIC_0008524;300;4;2;100.0;0.6;4288;2848;12212224;3661618;4070;3661618;323767;319697;3665688;355
ISIC_0014428;350;4;1;10.0;0.6;4288;2848;12212224;1197904;6259;1197904;525860;519601;1204163;409
ISIC_0014428;50;2;2;0.1;0.6;4288;2848;12212224;3037949;0;3037949;525860;525860;3037949;22
ISIC_0003657;100;1;3;100.0;0.6;3024;2016;6096384;2754160;30;2754160;340261;340231;2754190;75
ISIC_0007332;100;2;3;0.01;0.6;3024;2016;6096384;0;530766;0;530766;0;530766;86
ISIC_0012547;300;1;2;100.0;0.6;4288;2848;12212224;11388053;0;11388053;572681;572681;11388053;310
ISIC_0014428;250;4;1;100.0;0.6;4288;2848;12212224;1317627;4628;1317627;525860;521232;1322255;290
ISIC_0012547;50;3;3;1.0;0.6;4288;2848;12212224;10797256;0;10797256;572681;572681;10797256;43
ISIC_0007332;50;1;3;0.1;0.6;3024;2016;6096384;5350305;0;5350305;530766;530766;5350305;12
ISIC_0008524;50;1;2;0.01;0.6;4288;2848;12212224;7591532;0;7591532;323767;323767;7591532;6
ISIC_0013082;100;2;2;100.0;0.6;3872;2592;10036224;2998280;0;2998280;254836;254836;2998280;85
ISIC_0014712;100;1;2;0.1;0.6;6621;4422;29278062;3533417;10888289;3533417;24292916;13404627;14421706;67
ISIC_0013128;50;4;3;10.0;0.6;3872;2592;10036224;6779097;0;6779097;470897;470897;6779097;59
ISIC_0013128;250;2;3;0.1;0.6;3872;2592;10036224;5403206;0;5403206;470897;470897;5403206;267
ISIC_0003657;100;4;1;0.1;0.6;3024;2016;6096384;2403496;3306;2403496;340261;336955;2406802;107
ISIC_0013188;400;3;3;1.0;0.6;3008;2000;6016000;3234519;0;3234519;92544;92544;3234519;463
ISIC_0014712;350;1;2;100.0;0.6;6621;4422;29278062;1259775;15588494;1259775;24292916;8704422;16848269;370
ISIC_0007332;300;4;2;100.0;0.6;3024;2016;6096384;5088423;0;5088423;530766;530766;5088423;355
